date,state,daily_partial,daily_full,daily,daily_partial_child,daily_full_child,cumul_partial,cumul_full,cumul,cumul_partial_child,cumul_full_child,pfizer1,pfizer2,sinovac1,sinovac2,astra1,astra2,cansino,pending
6/1/21,Johor,7854,2123,9977,0,0,187294,98011,285305,0,0,5821,1971,1924,152,108,0,0,1
6/1/21,Kedah,8523,666,9189,0,0,127793,70241,198034,0,0,5073,631,3383,35,60,0,0,7
6/1/21,Kelantan,7131,2140,9271,0,0,97597,55051,152648,0,0,2472,2081,4657,59,0,0,0,2
6/1/21,Melaka,2358,506,2864,0,0,49804,36433,86237,0,0,1139,406,1219,100,0,0,0,0
6/1/21,Negeri Sembilan,1837,2614,4451,0,0,77183,55965,133148,0,0,298,2540,1539,74,0,0,0,0
6/1/21,Pahang,1859,2997,4856,0,0,104983,79235,184218,0,0,1475,1457,384,1540,0,0,0,0
6/1/21,Perak,4602,3617,8219,0,0,161940,105221,267161,0,0,943,3543,3656,73,0,0,0,4
6/1/21,Perlis,1959,60,2019,0,0,31919,19102,51021,0,0,1942,44,17,16,0,0,0,0
6/1/21,Pulau Pinang,3880,803,4683,0,0,94623,73563,168186,0,0,1044,682,2713,121,123,0,0,0
6/1/21,Sabah,1501,946,2447,0,0,140776,87659,228435,0,0,577,797,923,149,0,0,0,1
6/1/21,Sarawak,270,139,409,0,0,198783,115332,314115,0,0,173,0,97,139,0,0,0,0
6/1/21,Selangor,13994,2174,16168,0,0,283316,141743,425059,0,0,6422,1882,3389,292,4182,0,0,1
6/1/21,Terengganu,3443,1766,5209,0,0,78557,49544,128101,0,0,296,1764,3146,2,0,0,0,1
6/1/21,W.P. Kuala Lumpur,15276,2719,17995,0,0,345587,102325,447912,0,0,2678,2600,3040,117,9556,2,0,2
6/1/21,W.P. Labuan,0,391,391,0,0,14002,11697,25699,0,0,0,373,0,18,0,0,0,0
6/1/21,W.P. Putrajaya,809,724,1533,0,0,22633,12145,34778,0,0,306,410,503,314,0,0,0,0
6/2/21,Johor,9199,178,9377,0,0,196493,98189,294682,0,0,7190,56,1816,122,193,0,0,0
6/2/21,Kedah,10574,271,10845,0,0,138367,70512,208879,0,0,4723,231,5808,40,43,0,0,0
6/2/21,Kelantan,8501,173,8674,0,0,106098,55224,161322,0,0,2068,161,6428,12,0,0,0,5
6/2/21,Melaka,2935,44,2979,0,0,52739,36477,89216,0,0,1331,43,1604,1,0,0,0,0
6/2/21,Negeri Sembilan,3008,353,3361,0,0,80191,56318,136509,0,0,697,262,2274,91,36,0,0,1
6/2/21,Pahang,4257,798,5055,0,0,109240,80033,189273,0,0,3249,46,1008,752,0,0,0,0
6/2/21,Perak,7501,286,7787,0,0,169441,105507,274948,0,0,762,284,6688,2,48,0,0,3
6/2/21,Perlis,2119,17,2136,0,0,34038,19119,53157,0,0,521,1,1598,16,0,0,0,0
6/2/21,Pulau Pinang,4426,477,4903,0,0,99049,74040,173089,0,0,1001,349,3369,128,55,0,0,1
6/2/21,Sabah,5941,2320,8261,0,0,146717,89979,236696,0,0,3544,2060,2396,260,0,0,0,1
6/2/21,Sarawak,401,146,547,0,0,199184,115478,314662,0,0,51,0,350,146,0,0,0,0
6/2/21,Selangor,16830,1744,18574,0,0,300146,143487,443633,0,0,7236,1578,4892,166,4701,0,0,1
6/2/21,Terengganu,3933,704,4637,0,0,82490,50248,132738,0,0,313,702,3614,2,0,0,0,6
6/2/21,W.P. Kuala Lumpur,15372,1687,17059,0,0,360959,104012,464971,0,0,2702,1563,3234,124,9430,0,0,6
6/2/21,W.P. Labuan,432,364,796,0,0,14434,12061,26495,0,0,432,364,0,0,0,0,0,0
6/2/21,W.P. Putrajaya,1399,280,1679,0,0,24032,12425,36457,0,0,334,275,1065,5,0,0,0,0
6/3/21,Johor,7751,14,7765,0,0,204244,98203,302447,0,0,4872,4,2641,10,238,0,0,0
6/3/21,Kedah,10708,183,10891,0,0,149075,70695,219770,0,0,4822,176,5885,7,0,0,0,1
6/3/21,Kelantan,9057,332,9389,0,0,115155,55556,170711,0,0,2258,233,6786,99,11,0,0,2
6/3/21,Melaka,3729,7,3736,0,0,56468,36484,92952,0,0,1945,6,1784,1,0,0,0,0
6/3/21,Negeri Sembilan,3589,0,3589,0,0,83780,56318,140098,0,0,637,0,2952,0,0,0,0,0
6/3/21,Pahang,5923,74,5997,0,0,115163,80107,195270,0,0,2022,57,3901,17,0,0,0,0
6/3/21,Perak,8103,4,8107,0,0,177544,105511,283055,0,0,895,4,6921,0,285,0,0,2
6/3/21,Perlis,2257,16,2273,0,0,36295,19135,55430,0,0,2238,16,19,0,0,0,0,0
6/3/21,Pulau Pinang,5349,71,5420,0,0,104398,74111,178509,0,0,1289,68,3925,3,134,0,0,1
6/3/21,Sabah,8422,1433,9855,0,0,155139,91412,246551,0,0,4884,1278,3532,155,0,0,0,6
6/3/21,Sarawak,6656,5130,11786,0,0,205840,120608,326448,0,0,31,903,6625,4226,0,0,0,1
6/3/21,Selangor,18424,98,18522,0,0,318570,143585,462155,0,0,8463,55,5387,43,4573,0,0,1
6/3/21,Terengganu,2849,12,2861,0,0,85339,50260,135599,0,0,196,9,2653,3,0,0,0,0
6/3/21,W.P. Kuala Lumpur,16365,28,16393,0,0,377324,104040,481364,0,0,3316,20,3502,7,9545,1,0,2
6/3/21,W.P. Labuan,554,393,947,0,0,14988,12454,27442,0,0,554,393,0,0,0,0,0,0
6/3/21,W.P. Putrajaya,1433,7,1440,0,0,25465,12432,37897,0,0,351,2,1081,5,0,0,0,1
6/4/21,Johor,1782,0,1782,0,0,206026,98203,304229,0,0,886,0,896,0,0,0,0,0
6/4/21,Kedah,4987,4,4991,0,0,154062,70699,224761,0,0,717,1,4270,3,0,0,0,0
6/4/21,Kelantan,463,0,463,0,0,115618,55556,171174,0,0,0,0,463,0,0,0,0,0
6/4/21,Melaka,3537,10,3547,0,0,60005,36494,96499,0,0,1177,5,2360,5,0,0,0,0
6/4/21,Negeri Sembilan,3207,34,3241,0,0,86987,56352,143339,0,0,540,33,2655,1,12,0,0,0
6/4/21,Pahang,4079,87,4166,0,0,119242,80194,199436,0,0,1148,56,2930,31,0,0,0,1
6/4/21,Perak,9072,135,9207,0,0,186616,105646,292262,0,0,3399,45,4420,90,1242,0,0,11
6/4/21,Perlis,1228,3,1231,0,0,37523,19138,56661,0,0,61,2,1167,1,0,0,0,0
6/4/21,Pulau Pinang,5601,62,5663,0,0,109999,74173,184172,0,0,1310,37,4170,25,119,0,0,2
6/4/21,Sabah,10039,842,10881,0,0,165178,92254,257432,0,0,4894,799,5144,43,0,0,0,1
6/4/21,Sarawak,7765,2871,10636,0,0,213605,123479,337084,0,0,1904,926,5746,1944,110,0,0,6
6/4/21,Selangor,16322,236,16558,0,0,334892,143821,478713,0,0,6985,210,4474,26,4863,0,0,0
6/4/21,Terengganu,0,1,1,0,0,85339,50261,135600,0,0,0,1,0,0,0,0,0,0
6/4/21,W.P. Kuala Lumpur,16191,572,16763,3,0,393515,104612,498127,3,0,3619,564,3124,7,9447,1,0,1
6/4/21,W.P. Labuan,585,64,649,0,0,15573,12518,28091,0,0,472,26,113,38,0,0,0,0
6/4/21,W.P. Putrajaya,1379,13,1392,0,0,26844,12445,39289,0,0,388,8,991,5,0,0,0,0
6/5/21,Johor,10502,276,10778,0,0,216528,98479,315007,0,0,9359,268,1142,8,0,0,0,1
6/5/21,Kedah,3397,0,3397,0,0,157459,70699,228158,0,0,0,0,3397,0,0,0,0,0
6/5/21,Kelantan,763,5,768,0,0,116381,55561,171942,0,0,643,0,120,5,0,0,0,0
6/5/21,Melaka,2156,1,2157,0,0,62161,36495,98656,0,0,616,1,1540,0,0,0,0,0
6/5/21,Negeri Sembilan,1089,0,1089,0,0,88076,56352,144428,0,0,450,0,639,0,0,0,0,0
6/5/21,Pahang,2121,17,2138,0,0,121363,80211,201574,0,0,1,0,1885,17,234,0,0,1
6/5/21,Perak,7072,93,7165,0,0,193688,105739,299427,0,0,3483,93,2639,0,945,0,0,5
6/5/21,Perlis,783,0,783,0,0,38306,19138,57444,0,0,0,0,783,0,0,0,0,0
6/5/21,Pulau Pinang,3601,14,3615,0,0,113600,74187,187787,0,0,1160,14,2440,0,0,0,0,1
6/5/21,Sabah,8978,452,9430,0,0,174156,92706,266862,0,0,5403,447,3575,5,0,0,0,0
6/5/21,Sarawak,10614,45,10659,0,0,224219,123524,347743,0,0,8899,33,1700,11,11,0,0,5
6/5/21,Selangor,10383,100,10483,0,0,345275,143921,489196,0,0,3838,83,2359,17,4182,0,0,4
6/5/21,Terengganu,923,0,923,0,0,86262,50261,136523,0,0,0,0,432,0,491,0,0,0
6/5/21,W.P. Kuala Lumpur,9413,0,9413,0,0,402928,104612,507540,3,0,1,0,16,0,9396,0,0,0
6/5/21,W.P. Labuan,247,385,632,0,0,15820,12903,28723,0,0,247,385,0,0,0,0,0,0
6/5/21,W.P. Putrajaya,1,0,1,0,0,26845,12445,39290,0,0,1,0,0,0,0,0,0,0
6/6/21,Johor,10611,153,10764,0,0,227139,98632,325771,0,0,10508,153,16,0,86,0,0,1
6/6/21,Kedah,10317,191,10508,0,0,167776,70890,238666,0,0,6052,156,4165,35,92,0,0,8
6/6/21,Kelantan,6784,435,7219,0,0,123165,55996,179161,0,0,5951,417,833,18,0,0,0,0
6/6/21,Melaka,0,0,0,0,0,62161,36495,98656,0,0,0,0,0,0,0,0,0,0
6/6/21,Negeri Sembilan,1064,0,1064,0,0,89140,56352,145492,0,0,450,0,581,0,33,0,0,0
6/6/21,Pahang,4170,3,4173,0,0,125533,80214,205747,0,0,0,0,4169,3,0,0,0,1
6/6/21,Perak,7803,22,7825,0,0,201491,105761,307252,0,0,3612,22,3248,0,942,0,0,1
6/6/21,Perlis,0,0,0,0,0,38306,19138,57444,0,0,0,0,0,0,0,0,0,0
6/6/21,Pulau Pinang,1,2,3,0,0,113601,74189,187790,0,0,1,2,0,0,0,0,0,0
6/6/21,Sabah,7509,29,7538,1,0,181665,92735,274400,1,0,4250,24,3259,4,0,0,0,1
6/6/21,Sarawak,14590,117,14707,0,0,238809,123641,362450,0,0,4092,89,10441,28,55,0,0,2
6/6/21,Selangor,5619,2,5621,0,0,350894,143923,494817,0,0,1,0,1502,2,4116,0,0,0
6/6/21,Terengganu,3583,617,4200,0,0,89845,50878,140723,0,0,3569,617,6,0,8,0,0,0
6/6/21,W.P. Kuala Lumpur,8798,1,8799,0,0,411726,104613,516339,3,0,36,0,71,1,8691,0,0,0
6/6/21,W.P. Labuan,0,0,0,0,0,15820,12903,28723,0,0,0,0,0,0,0,0,0,0
6/6/21,W.P. Putrajaya,0,0,0,0,0,26845,12445,39290,0,0,0,0,0,0,0,0,0,0
6/7/21,Johor,2877,576,3453,0,0,230016,99208,329224,0,0,530,576,1348,0,999,0,0,0
6/7/21,Kedah,2960,5,2965,0,0,170736,70895,241631,0,0,876,4,2084,1,0,0,0,0
6/7/21,Kelantan,274,221,495,0,0,123439,56217,179656,0,0,1,219,273,2,0,0,0,0
6/7/21,Melaka,0,0,0,0,0,62161,36495,98656,0,0,0,0,0,0,0,0,0,0
6/7/21,Negeri Sembilan,630,1,631,1,0,89770,56353,146123,1,0,0,0,630,0,0,0,0,1
6/7/21,Pahang,52,0,52,0,0,125585,80214,205799,0,0,1,0,50,0,0,0,0,1
6/7/21,Perak,653,1,654,0,0,202144,105762,307906,0,0,162,1,480,0,0,0,0,11
6/7/21,Perlis,0,0,0,0,0,38306,19138,57444,0,0,0,0,0,0,0,0,0,0
6/7/21,Pulau Pinang,1531,0,1531,0,0,115132,74189,189321,0,0,0,0,492,0,1038,0,0,1
6/7/21,Sabah,6749,828,7577,3,0,188414,93563,281977,4,0,5186,446,1559,382,0,0,0,4
6/7/21,Sarawak,14926,227,15153,0,0,253735,123868,377603,0,0,2528,31,11113,195,1285,0,0,1
6/7/21,Selangor,9393,1,9394,0,0,360287,143924,504211,0,0,0,0,4899,1,4494,0,0,0
6/7/21,Terengganu,0,301,301,0,0,89845,51179,141024,0,0,0,301,0,0,0,0,0,0
6/7/21,W.P. Kuala Lumpur,19767,2931,22698,0,0,431493,107544,539037,3,0,1666,1977,7688,954,10412,0,0,1
6/7/21,W.P. Labuan,51,0,51,0,0,15871,12903,28774,0,0,51,0,0,0,0,0,0,0
6/7/21,W.P. Putrajaya,751,0,751,0,0,27596,12445,40041,0,0,228,0,523,0,0,0,0,0
6/8/21,Johor,10079,8247,18326,0,0,240095,107455,347550,0,0,7169,7753,1884,493,1026,0,0,1
6/8/21,Kedah,8633,1547,10180,0,0,179369,72442,251811,0,0,6215,906,2346,641,72,0,0,0
6/8/21,Kelantan,7242,2737,9979,0,0,130681,58954,189635,0,0,4397,2521,2845,216,0,0,0,0
6/8/21,Melaka,3555,200,3755,0,0,65716,36695,102411,0,0,2114,197,1357,3,84,0,0,0
6/8/21,Negeri Sembilan,2786,3768,6554,0,0,92556,60121,152677,1,0,965,3645,1718,123,102,0,0,1
6/8/21,Pahang,5212,1321,6533,0,0,130797,81535,212332,0,0,4907,1135,288,186,17,0,0,0
6/8/21,Perak,7086,2846,9932,0,0,209230,108608,317838,0,0,5487,2831,486,14,1113,0,0,1
6/8/21,Perlis,880,890,1770,0,0,39186,20028,59214,0,0,846,882,34,8,0,0,0,0
6/8/21,Pulau Pinang,6850,770,7620,0,0,121982,74959,196941,0,0,2413,718,3396,52,1035,0,0,6
6/8/21,Sabah,8591,3444,12035,1,0,197005,97007,294012,5,0,6666,2816,1905,628,0,0,0,20
6/8/21,Sarawak,6998,5448,12446,0,0,260733,129316,390049,0,0,2141,5128,3517,320,1340,0,0,0
6/8/21,Selangor,17155,6291,23446,1,0,377442,150215,527657,1,0,4317,5773,7936,511,4900,0,0,9
6/8/21,Terengganu,835,3055,3890,0,0,90680,54234,144914,0,0,412,3011,52,41,370,1,0,3
6/8/21,W.P. Kuala Lumpur,21499,4160,25659,0,0,452992,111704,564696,3,0,2271,2737,8705,1423,10521,0,0,2
6/8/21,W.P. Labuan,298,228,526,0,0,16169,13131,29300,0,0,298,219,0,9,0,0,0,0
6/8/21,W.P. Putrajaya,388,1154,1542,0,0,27984,13599,41583,0,0,385,835,3,319,0,0,0,0
6/9/21,Johor,12618,6005,18623,0,0,252713,113460,366173,0,0,8576,2845,2962,3159,1080,0,0,1
6/9/21,Kedah,7109,3192,10301,0,0,186478,75634,262112,0,0,4783,1864,2254,1326,72,0,0,2
6/9/21,Kelantan,8127,2891,11018,0,0,138808,61845,200653,0,0,4504,2532,3621,359,0,0,0,2
6/9/21,Melaka,3590,327,3917,0,0,69306,37022,106328,0,0,2236,323,1306,1,48,0,0,3
6/9/21,Negeri Sembilan,4393,1524,5917,0,0,96949,61645,158594,1,0,2323,1361,2003,163,67,0,0,0
6/9/21,Pahang,6018,2051,8069,0,0,136815,83586,220401,0,0,4887,1997,1121,54,0,0,0,10
6/9/21,Perak,8456,2264,10720,0,0,217686,110872,328558,0,0,7648,2221,535,40,264,0,0,12
6/9/21,Perlis,1459,762,2221,0,0,40645,20790,61435,0,0,930,747,529,15,0,0,0,0
6/9/21,Pulau Pinang,7969,496,8465,0,0,129951,75455,205406,0,0,4186,427,2565,69,1217,0,0,1
6/9/21,Sabah,9930,3547,13477,0,0,206935,100554,307489,5,0,8392,2990,1535,556,0,0,0,4
6/9/21,Sarawak,5217,3920,9137,0,0,265950,133236,399186,0,0,899,3577,2907,343,1411,0,0,0
6/9/21,Selangor,19661,5461,25122,0,0,397103,155676,552779,1,0,7592,5029,8633,432,3435,0,0,1
6/9/21,Terengganu,2446,2362,4808,0,0,93126,56596,149722,0,0,1871,2245,50,115,524,0,0,3
6/9/21,W.P. Kuala Lumpur,17861,4859,22720,0,0,470853,116563,587416,3,0,1490,2745,8590,2112,7781,0,0,2
6/9/21,W.P. Labuan,605,43,648,0,0,16774,13174,29948,0,0,359,25,246,18,0,0,0,0
6/9/21,W.P. Putrajaya,556,868,1424,0,0,28540,14467,43007,0,0,553,527,3,341,0,0,0,0
6/10/21,Johor,14328,4564,18892,0,0,267041,118024,385065,0,0,9876,3599,1788,965,2664,0,0,0
6/10/21,Kedah,6237,3730,9967,0,0,192715,79364,272079,0,0,4287,1462,1930,2266,20,0,0,2
6/10/21,Kelantan,7102,3656,10758,0,0,145910,65501,211411,0,0,3792,3310,3298,346,12,0,0,0
6/10/21,Melaka,2393,623,3016,0,0,71699,37645,109344,0,0,705,430,1616,193,72,0,0,0
6/10/21,Negeri Sembilan,4747,1439,6186,0,0,101696,63084,164780,1,0,2094,1250,2554,189,98,0,0,1
6/10/21,Pahang,5026,2737,7763,0,0,141841,86323,228164,0,0,4136,1478,874,1259,16,0,0,0
6/10/21,Perak,5552,4717,10269,0,0,223238,115589,338827,0,0,4313,1915,1237,2801,1,0,0,2
6/10/21,Perlis,1620,1035,2655,0,0,42265,21825,64090,0,0,1594,1022,26,13,0,0,0,0
6/10/21,Pulau Pinang,8052,2186,10238,0,0,138003,77641,215644,0,0,2677,2049,2382,137,2993,0,0,0
6/10/21,Sabah,9942,3810,13752,0,0,216877,104364,321241,5,0,8233,2953,1648,856,0,0,0,62
6/10/21,Sarawak,6024,2095,8119,1,0,271974,135331,407305,1,0,390,1745,2133,350,3501,0,0,0
6/10/21,Selangor,19333,7854,27187,0,0,416436,163530,579966,1,0,5632,5590,10409,2264,3292,0,0,0
6/10/21,Terengganu,1152,2698,3850,0,0,94278,59294,153572,0,0,694,2522,94,171,363,0,0,6
6/10/21,W.P. Kuala Lumpur,20940,4883,25823,1,0,491793,121446,613239,4,0,2921,2665,9431,2216,8586,0,0,4
6/10/21,W.P. Labuan,618,16,634,0,0,17392,13190,30582,0,0,310,13,308,3,0,0,0,0
6/10/21,W.P. Putrajaya,441,1205,1646,0,0,28981,15672,44653,0,0,300,690,141,514,0,0,0,1
6/11/21,Johor,5304,598,5902,0,0,272345,118622,390967,0,0,1247,6,1399,592,2658,0,0,0
6/11/21,Kedah,1606,688,2294,0,0,194321,80052,274373,0,0,566,19,1027,669,0,0,0,13
6/11/21,Kelantan,537,20,557,0,0,146447,65521,211968,0,0,96,0,441,20,0,0,0,0
6/11/21,Melaka,2186,684,2870,0,0,73885,38329,112214,0,0,292,518,1810,166,84,0,0,0
6/11/21,Negeri Sembilan,3855,1038,4893,0,0,105551,64122,169673,1,0,1083,1016,2680,22,91,0,0,1
6/11/21,Pahang,3678,2331,6009,0,0,145519,88654,234173,0,0,2657,377,1017,1952,3,0,0,3
6/11/21,Perak,5084,6466,11550,1,0,228322,122055,350377,1,0,4455,2288,550,4177,77,0,0,3
6/11/21,Perlis,995,493,1488,0,0,43260,22318,65578,0,0,658,493,337,0,0,0,0,0
6/11/21,Pulau Pinang,9098,995,10093,0,0,147101,78636,225737,0,0,2917,888,3123,107,3057,0,0,1
6/11/21,Sabah,10686,3027,13713,0,0,227563,107391,334954,5,0,8671,2570,2014,457,0,0,0,1
6/11/21,Sarawak,9648,2897,12545,0,0,281622,138228,419850,1,0,1368,2812,4657,84,3623,0,0,1
6/11/21,Selangor,20165,5345,25510,0,0,436601,168875,605476,1,0,4775,3986,10737,1357,4653,1,0,1
6/11/21,Terengganu,182,0,182,0,0,94460,59294,153754,0,0,181,0,0,0,1,0,0,0
6/11/21,W.P. Kuala Lumpur,22325,4330,26655,0,0,514118,125776,639894,4,0,1516,2796,10665,1533,10144,0,0,1
6/11/21,W.P. Labuan,381,98,479,0,0,17773,13288,31061,0,0,160,16,221,82,0,0,0,0
6/11/21,W.P. Putrajaya,397,1166,1563,0,0,29378,16838,46216,0,0,266,826,131,340,0,0,0,0
6/12/21,Johor,10310,8408,18718,1,0,282655,127030,409685,1,0,8355,1107,82,7282,1873,0,0,19
6/12/21,Kedah,1049,842,1891,0,0,195370,80894,276264,0,0,427,210,614,632,0,0,0,8
6/12/21,Kelantan,140,16,156,0,0,146587,65537,212124,0,0,42,0,98,16,0,0,0,0
6/12/21,Melaka,2034,503,2537,0,0,75919,38832,114751,0,0,592,8,1442,495,0,0,0,0
6/12/21,Negeri Sembilan,1180,88,1268,0,0,106731,64210,170941,1,0,291,16,889,72,0,0,0,0
6/12/21,Pahang,1272,4353,5625,0,0,146791,93007,239798,0,0,762,6,510,4347,0,0,0,0
6/12/21,Perak,4260,5148,9408,0,0,232582,127203,359785,1,0,4187,172,72,4974,0,0,0,3
6/12/21,Perlis,0,0,0,0,0,43260,22318,65578,0,0,0,0,0,0,0,0,0,0
6/12/21,Pulau Pinang,6078,10,6088,0,0,153179,78646,231825,0,0,2155,10,1836,0,2086,0,0,1
6/12/21,Sabah,12006,2017,14023,1,0,239569,109408,348977,6,0,9688,1744,2310,273,0,0,0,8
6/12/21,Sarawak,25447,8866,34313,2,0,307069,147094,454163,3,0,8882,8846,13845,12,2704,0,0,24
6/12/21,Selangor,13664,3468,17132,0,0,450265,172343,622608,1,0,1966,2046,7719,1421,3979,0,0,1
6/12/21,Terengganu,1897,2,1899,0,0,96357,59296,155653,0,0,1390,1,507,0,0,0,0,1
6/12/21,W.P. Kuala Lumpur,23107,234,23341,0,0,537225,126010,663235,4,0,825,210,12358,23,9924,1,0,0
6/12/21,W.P. Labuan,439,45,484,0,0,18212,13333,31545,0,0,439,45,0,0,0,0,0,0
6/12/21,W.P. Putrajaya,0,0,0,0,0,29378,16838,46216,0,0,0,0,0,0,0,0,0,0
6/13/21,Johor,12759,3539,16298,1,0,295414,130569,425983,2,0,10717,3351,11,188,2031,0,0,0
6/13/21,Kedah,4691,4596,9287,0,0,200061,85490,285551,0,0,3911,2491,775,2100,5,0,0,5
6/13/21,Kelantan,5314,3229,8543,0,0,151901,68766,220667,0,0,3792,316,1424,2912,98,0,0,1
6/13/21,Melaka,0,0,0,0,0,75919,38832,114751,0,0,0,0,0,0,0,0,0,0
6/13/21,Negeri Sembilan,898,0,898,0,0,107629,64210,171839,1,0,245,0,653,0,0,0,0,0
6/13/21,Pahang,1413,76,1489,0,0,148204,93083,241287,0,0,1413,72,0,4,0,0,0,0
6/13/21,Perak,3871,4482,8353,0,0,236453,131685,368138,1,0,3525,259,247,4221,99,0,0,2
6/13/21,Perlis,0,1,1,0,0,43260,22319,65579,0,0,0,1,0,0,0,0,0,0
6/13/21,Pulau Pinang,1996,0,1996,0,0,155175,78646,233821,0,0,0,0,0,0,1996,0,0,0
6/13/21,Sabah,8508,1218,9726,0,0,248077,110626,358703,6,0,7871,927,637,291,0,0,0,0
6/13/21,Sarawak,26425,7302,33727,0,0,333494,154396,487890,3,0,7901,4311,15757,2991,2763,0,0,4
6/13/21,Selangor,10877,0,10877,0,0,461142,172343,633485,1,0,40,0,6271,0,4566,0,0,0
6/13/21,Terengganu,3946,2414,6360,0,1,100303,61710,162013,0,1,2674,727,1272,1683,0,0,0,4
6/13/21,W.P. Kuala Lumpur,23758,13,23771,0,0,560983,126023,687006,4,0,897,5,12706,8,10154,0,0,1
6/13/21,W.P. Labuan,0,0,0,0,0,18212,13333,31545,0,0,0,0,0,0,0,0,0,0
6/13/21,W.P. Putrajaya,0,0,0,0,0,29378,16838,46216,0,0,0,0,0,0,0,0,0,0
6/14/21,Johor,15179,5443,20622,0,0,310593,136012,446605,2,0,10854,3293,1486,2149,2839,0,0,1
6/14/21,Kedah,4332,5665,9997,0,0,204393,91155,295548,0,0,3615,3524,716,2136,0,0,0,6
6/14/21,Kelantan,6686,3483,10169,0,0,158587,72249,230836,0,0,4284,342,2402,3141,0,0,0,0
6/14/21,Melaka,1608,1283,2891,0,0,77527,40115,117642,0,0,351,454,1245,829,12,0,0,0
6/14/21,Negeri Sembilan,4698,980,5678,0,0,112327,65190,177517,1,0,1267,803,3306,177,124,0,0,1
6/14/21,Pahang,3060,3422,6482,0,0,151264,96505,247769,0,0,2731,1767,329,1655,0,0,0,0
6/14/21,Perak,5753,4100,9853,1,0,242206,135785,377991,2,0,5298,605,452,3495,0,0,0,3
6/14/21,Perlis,1887,1276,3163,0,0,45147,23595,68742,0,0,1829,913,58,361,0,0,0,2
6/14/21,Pulau Pinang,7939,1759,9698,0,0,163114,80405,243519,0,0,4160,1115,776,644,3003,0,0,0
6/14/21,Sabah,10682,3178,13860,0,0,258759,113804,372563,6,0,7734,2171,2947,1007,0,0,0,1
6/14/21,Sarawak,33423,11021,44444,1,0,366917,165417,532334,4,0,1631,1734,28100,9287,3645,0,0,47
6/14/21,Selangor,24575,6313,30888,0,0,485717,178656,664373,1,0,4547,5252,14882,1059,5146,0,0,2
6/14/21,Terengganu,4034,2353,6387,0,0,104337,64063,168400,0,1,2645,348,1350,2003,36,0,0,5
6/14/21,W.P. Kuala Lumpur,21307,4429,25736,0,0,582290,130452,712742,4,0,2018,1985,9083,2442,10206,0,0,2
6/14/21,W.P. Labuan,1178,20,1198,0,0,19390,13353,32743,0,0,1178,20,0,0,0,0,0,0
6/14/21,W.P. Putrajaya,433,961,1394,0,0,29811,17799,47610,0,0,427,825,6,136,0,0,0,0
6/15/21,Johor,13335,7275,20610,0,0,323928,143287,467215,2,0,8205,1757,2235,5515,2895,0,0,3
6/15/21,Kedah,4296,4483,8779,0,0,208689,95638,304327,0,0,3417,3455,874,1026,1,0,0,6
6/15/21,Kelantan,8090,4214,12304,0,0,166677,76463,243140,0,0,4555,608,3535,3605,0,0,0,1
6/15/21,Melaka,2073,1263,3336,0,0,79600,41378,120978,0,0,924,756,1149,507,0,0,0,0
6/15/21,Negeri Sembilan,5520,2082,7602,1,0,117847,67272,185119,2,0,2963,845,2500,1237,54,0,0,3
6/15/21,Pahang,6150,1649,7799,0,0,157414,98154,255568,0,0,5359,1558,714,91,77,0,0,0
6/15/21,Perak,6247,4188,10435,0,0,248453,139973,388426,2,0,5375,729,868,3458,4,0,0,1
6/15/21,Perlis,1844,1394,3238,0,0,46991,24989,71980,0,0,1752,961,92,433,0,0,0,0
6/15/21,Pulau Pinang,8457,1871,10328,0,0,171571,82276,253847,0,0,4797,914,676,957,2984,0,0,0
6/15/21,Sabah,12878,4270,17148,0,0,271637,118074,389711,6,0,9528,2876,3330,1394,0,0,0,20
6/15/21,Sarawak,39035,8642,47677,1,0,405952,174059,580011,5,0,1020,1393,34610,7249,3400,0,0,5
6/15/21,Selangor,28111,6844,34955,0,0,513828,185500,699328,1,0,5277,5717,17733,1127,5101,0,0,0
6/15/21,Terengganu,4099,2218,6317,0,0,108436,66281,174717,0,1,2662,201,1413,2017,24,0,0,0
6/15/21,W.P. Kuala Lumpur,24140,4744,28884,1,0,606430,135196,741626,5,0,2646,1887,11636,2857,9858,0,0,0
6/15/21,W.P. Labuan,940,12,952,0,0,20330,13365,33695,0,0,401,5,539,7,0,0,0,0
6/15/21,W.P. Putrajaya,726,831,1557,0,0,30537,18630,49167,0,0,682,357,44,474,0,0,0,0
6/16/21,Johor,16933,405,17338,2,0,340861,143692,484553,4,0,11466,99,2847,306,2620,0,0,0
6/16/21,Kedah,3864,1016,4880,0,0,212553,96654,309207,0,0,2945,761,919,255,0,0,0,0
6/16/21,Kelantan,11606,935,12541,0,0,178283,77398,255681,0,0,5592,554,6014,381,0,0,0,0
6/16/21,Melaka,5159,15,5174,0,0,84759,41393,126152,0,0,2202,13,2508,2,449,0,0,0
6/16/21,Negeri Sembilan,5543,1095,6638,0,0,123390,68367,191757,2,0,2821,50,2720,1045,0,0,0,2
6/16/21,Pahang,5540,87,5627,0,0,162954,98241,261195,0,0,4542,35,998,52,0,0,0,0
6/16/21,Perak,2471,13,2484,0,0,250924,139986,390910,2,0,1627,8,843,5,1,0,0,0
6/16/21,Perlis,2598,36,2634,0,0,49589,25025,74614,0,0,2492,26,106,10,0,0,0,0
6/16/21,Pulau Pinang,9901,109,10010,2,0,181472,82385,263857,2,0,6367,92,1213,16,2319,0,0,3
6/16/21,Sabah,16398,1886,18284,2,1,288035,119960,407995,8,1,11103,1362,5295,522,0,0,0,2
6/16/21,Sarawak,53458,702,54160,5,0,459410,174761,634171,10,0,1300,42,49100,660,3054,0,0,4
6/16/21,Selangor,35657,1061,36718,0,0,549485,186561,736046,1,0,7585,62,23115,999,4956,0,0,1
6/16/21,Terengganu,5322,220,5542,2,0,113758,66501,180259,2,1,3156,9,2129,211,36,0,0,1
6/16/21,W.P. Kuala Lumpur,28159,579,28738,2,0,634589,135775,770364,7,0,5132,252,12619,326,10408,1,0,0
6/16/21,W.P. Labuan,1166,13,1179,0,0,21496,13378,34874,0,0,1166,13,0,0,0,0,0,0
6/16/21,W.P. Putrajaya,1201,5,1206,0,0,31738,18635,50373,0,0,1123,4,78,1,0,0,0,0
6/17/21,Johor,14558,5971,20529,0,0,355419,149663,505082,4,0,9041,1407,2864,4564,2653,0,0,0
6/17/21,Kedah,3742,5196,8938,0,0,216295,101850,318145,0,0,3241,3246,501,1948,0,0,0,2
6/17/21,Kelantan,8640,3018,11658,0,0,186923,80416,267339,0,0,4473,309,4166,2709,0,0,0,1
6/17/21,Melaka,4946,1200,6146,0,0,89705,42593,132298,0,0,1497,916,1328,284,2121,0,0,0
6/17/21,Negeri Sembilan,5268,1386,6654,0,0,128658,69753,198411,2,0,2611,267,2643,1119,14,0,0,0
6/17/21,Pahang,3580,381,3961,0,0,166534,98622,265156,0,0,1971,256,1387,124,222,0,0,1
6/17/21,Perak,9239,1274,10513,0,0,260163,141260,401423,2,0,8398,549,828,724,12,0,0,2
6/17/21,Perlis,1415,1587,3002,0,0,51004,26612,77616,0,0,1306,1095,108,484,0,0,0,9
6/17/21,Pulau Pinang,9170,1975,11145,1,0,190642,84360,275002,3,0,5337,849,1212,1125,2621,0,0,1
6/17/21,Sabah,12299,4499,16798,0,0,300334,124459,424793,8,1,7439,2705,4848,1793,0,0,0,13
6/17/21,Sarawak,50143,3508,53651,0,0,509553,178269,687822,10,0,1325,2,45418,3506,3398,0,0,2
6/17/21,Selangor,29700,6841,36541,0,0,579185,193402,772587,1,0,5078,4606,19751,2233,4869,0,0,4
6/17/21,Terengganu,3379,1997,5376,0,0,117137,68498,185635,2,1,2180,75,1141,1921,58,0,0,1
6/17/21,W.P. Kuala Lumpur,24335,4738,29073,1,0,658924,140513,799437,8,0,2909,1829,11680,2908,9746,0,0,1
6/17/21,W.P. Labuan,2509,22,2531,0,0,24005,13400,37405,0,0,1790,5,719,17,0,0,0,0
6/17/21,W.P. Putrajaya,919,576,1495,0,0,32657,19211,51868,0,0,855,568,63,8,0,0,0,1
6/18/21,Johor,7172,1932,9104,0,0,362591,151595,514186,4,0,1902,23,2637,1909,2633,0,0,0
6/18/21,Kedah,1659,1128,2787,0,0,217954,102978,320932,0,0,1277,401,380,727,2,0,0,0
6/18/21,Kelantan,435,13,448,0,0,187358,80429,267787,0,0,0,0,435,13,0,0,0,0
6/18/21,Melaka,4662,1901,6563,0,0,94367,44494,138861,0,0,1564,1247,1058,654,2040,0,0,0
6/18/21,Negeri Sembilan,4403,1842,6245,0,0,133061,71595,204656,2,0,2146,703,2257,1139,0,0,0,0
6/18/21,Pahang,3434,401,3835,0,0,169968,99023,268991,0,0,2353,348,1081,53,0,0,0,0
6/18/21,Perak,8016,3212,11228,0,0,268179,144472,412651,2,0,7514,443,489,2769,11,0,0,2
6/18/21,Perlis,922,1074,1996,0,0,51926,27686,79612,0,0,370,338,552,736,0,0,0,0
6/18/21,Pulau Pinang,8103,2231,10334,0,0,198745,86591,285336,3,0,4169,832,1172,1399,2762,0,0,0
6/18/21,Sabah,11015,5138,16153,0,0,311349,129597,440946,8,1,7157,3148,3856,1990,2,0,0,0
6/18/21,Sarawak,49111,1928,51039,0,0,558664,180197,738861,10,0,1271,205,44401,1723,3437,0,0,2
6/18/21,Selangor,26841,6833,33674,1,0,606026,200235,806261,2,0,5267,4452,16819,2381,4754,0,0,1
6/18/21,Terengganu,0,0,0,0,0,117137,68498,185635,2,1,0,0,0,0,0,0,0,0
6/18/21,W.P. Kuala Lumpur,23290,3986,27276,2,0,682214,144499,826713,10,0,2708,1605,10980,2379,9601,0,0,3
6/18/21,W.P. Labuan,2313,42,2355,0,0,26318,13442,39760,0,0,2309,42,4,0,0,0,0,0
6/18/21,W.P. Putrajaya,706,927,1633,0,0,33363,20138,53501,0,0,699,724,7,203,0,0,0,0
6/19/21,Johor,8730,9980,18710,2,0,371321,161575,532896,6,0,5928,1824,843,8155,1958,0,0,2
6/19/21,Kedah,246,3128,3374,0,0,218200,106106,324306,0,0,224,2023,22,1105,0,0,0,0
6/19/21,Kelantan,551,4,555,0,0,187909,80433,268342,0,0,0,0,551,4,0,0,0,0
6/19/21,Melaka,5050,929,5979,0,0,99417,45423,144840,0,0,3366,0,1683,929,0,0,0,1
6/19/21,Negeri Sembilan,1279,820,2099,0,0,134340,72415,206755,2,0,389,175,889,645,0,0,0,1
6/19/21,Pahang,923,1209,2132,0,0,170891,100232,271123,0,0,905,1121,18,88,0,0,0,0
6/19/21,Perak,6142,3171,9313,0,0,274321,147643,421964,2,0,5999,43,143,3127,0,0,0,1
6/19/21,Perlis,1865,8,1873,0,0,53791,27694,81485,0,0,1407,6,457,2,0,0,0,1
6/19/21,Pulau Pinang,7736,19,7755,1,0,206481,86610,293091,4,0,3726,15,1962,4,2047,0,0,1
6/19/21,Sabah,12109,4192,16301,0,0,323458,133789,457247,8,1,8009,1491,4100,2699,0,0,0,2
6/19/21,Sarawak,43406,7234,50640,2,0,602070,187431,789501,12,0,16115,7073,24880,161,2410,0,0,1
6/19/21,Selangor,19416,4937,24353,1,0,625442,205172,830614,3,0,1894,2615,13316,2322,4205,0,0,1
6/19/21,Terengganu,128,482,610,0,0,117265,68980,186245,2,1,0,0,128,482,0,0,0,0
6/19/21,W.P. Kuala Lumpur,24697,25,24722,0,0,706911,144524,851435,10,0,1838,8,13629,17,9230,0,0,0
6/19/21,W.P. Labuan,2352,9,2361,1,0,28670,13451,42121,1,0,1826,5,526,4,0,0,0,0
6/19/21,W.P. Putrajaya,0,0,0,0,0,33363,20138,53501,0,0,0,0,0,0,0,0,0,0
6/20/21,Johor,7377,6397,13774,1,0,378698,167972,546670,7,0,4286,2484,1192,3913,1899,0,0,0
6/20/21,Kedah,592,1928,2520,0,0,218792,108034,326826,0,0,572,1309,20,618,0,0,0,1
6/20/21,Kelantan,4758,3705,8463,0,0,192667,84138,276805,0,0,3613,356,1144,3349,0,0,0,1
6/20/21,Melaka,2,0,2,0,0,99419,45423,144842,0,0,0,0,0,0,2,0,0,0
6/20/21,Negeri Sembilan,584,419,1003,0,0,134924,72834,207758,2,0,0,0,584,419,0,0,0,0
6/20/21,Pahang,1245,18,1263,0,0,172136,100250,272386,0,0,426,0,819,18,0,0,0,0
6/20/21,Perak,5375,2956,8331,0,0,279696,150599,430295,2,0,4358,19,1017,2937,0,0,0,0
6/20/21,Perlis,2147,6,2153,0,0,55938,27700,83638,0,0,1669,5,478,1,0,0,0,0
6/20/21,Pulau Pinang,2096,1,2097,0,0,208577,86611,295188,4,0,0,1,478,0,1618,0,0,0
6/20/21,Sabah,6503,1063,7566,0,1,329961,134852,464813,8,2,4473,504,2029,559,0,0,0,1
6/20/21,Sarawak,42449,4365,46814,1,0,644519,191796,836315,13,0,12016,4171,28023,194,2400,0,0,10
6/20/21,Selangor,15798,955,16753,1,0,641240,206127,847367,4,0,0,4,11692,951,4106,0,0,0
6/20/21,Terengganu,3089,2320,5409,0,0,120354,71300,191654,2,1,2432,42,656,2273,0,0,0,6
6/20/21,W.P. Kuala Lumpur,27342,24,27366,0,0,734253,144548,878801,10,0,1732,7,16646,17,8963,0,0,1
6/20/21,W.P. Labuan,1758,14,1772,0,0,30428,13465,43893,1,0,1754,14,4,0,0,0,0,0
6/20/21,W.P. Putrajaya,0,0,0,0,0,33363,20138,53501,0,0,0,0,0,0,0,0,0,0
6/21/21,Johor,8240,8618,16858,1,0,386938,176590,563528,8,0,2431,2023,2788,6595,3020,0,0,1
6/21/21,Kedah,2975,7432,10407,0,0,221767,115466,337233,0,0,2900,5615,75,1813,0,0,0,4
6/21/21,Kelantan,4892,5044,9936,0,0,197559,89182,286741,0,0,3820,1319,1072,3725,0,0,0,0
6/21/21,Melaka,4935,1489,6424,0,0,104354,46912,151266,0,0,1270,387,3445,1102,220,0,0,0
6/21/21,Negeri Sembilan,5062,1465,6527,0,0,139986,74299,214285,2,0,2683,126,2378,1339,0,0,0,1
6/21/21,Pahang,6296,1466,7762,0,0,178432,101716,280148,0,0,4012,1456,2284,10,0,0,0,0
6/21/21,Perak,6651,4241,10892,0,0,286347,154840,441187,2,0,2023,656,4613,3585,7,0,0,8
6/21/21,Perlis,1904,1886,3790,0,0,57842,29586,87428,0,0,1635,1882,268,4,0,0,0,1
6/21/21,Pulau Pinang,10202,2782,12984,0,0,218779,89393,308172,4,0,5397,741,1968,2040,2836,0,0,2
6/21/21,Sabah,9133,1085,10218,1,0,339094,135937,475031,9,2,5878,363,3100,719,153,0,0,5
6/21/21,Sarawak,62302,2350,64652,1,0,706821,194146,900967,14,0,2137,1460,56576,890,3583,0,0,6
6/21/21,Selangor,27045,8380,35425,0,0,668285,214507,882792,4,0,5047,6122,17403,2256,4592,1,0,4
6/21/21,Terengganu,3907,2267,6174,0,0,124261,73567,197828,2,1,2991,34,903,2233,12,0,0,1
6/21/21,W.P. Kuala Lumpur,32916,5180,38096,6,0,767169,149728,916897,16,0,1829,2656,19735,2514,11345,2,0,15
6/21/21,W.P. Labuan,2640,9,2649,0,0,33068,13474,46542,1,0,2640,9,0,0,0,0,0,0
6/21/21,W.P. Putrajaya,808,788,1596,0,0,34171,20926,55097,0,0,786,306,22,482,0,0,0,0
6/22/21,Johor,9649,7643,17292,1,0,396587,184233,580820,9,0,3314,5759,3116,1884,3219,0,0,0
6/22/21,Kedah,3014,8208,11222,0,0,224781,123674,348455,0,0,2698,4980,316,3225,0,3,0,0
6/22/21,Kelantan,4051,7067,11118,0,0,201610,96249,297859,0,0,3180,2423,871,4643,0,0,0,1
6/22/21,Melaka,4550,2320,6870,0,0,108904,49232,158136,0,0,2395,1122,1891,1198,264,0,0,0
6/22/21,Negeri Sembilan,7218,1768,8986,0,0,147204,76067,223271,2,0,4025,291,3192,1477,0,0,0,1
6/22/21,Pahang,7334,1843,9177,1,0,185766,103559,289325,1,0,4727,1469,2607,374,0,0,0,0
6/22/21,Perak,7048,4610,11658,0,0,293395,159450,452845,2,0,1620,909,5414,3698,7,0,0,10
6/22/21,Perlis,1830,1918,3748,0,0,59672,31504,91176,0,0,594,1902,1234,16,0,0,0,2
6/22/21,Pulau Pinang,10322,3672,13994,4,0,229101,93065,322166,8,0,3925,1003,3456,2668,2939,0,0,3
6/22/21,Sabah,9902,1326,11228,0,0,348996,137263,486259,9,2,5926,534,3812,792,163,0,0,1
6/22/21,Sarawak,59283,570,59853,14,0,766104,194716,960820,28,0,414,428,57989,142,880,0,0,0
6/22/21,Selangor,31620,9731,41351,2,0,699905,224238,924143,6,0,6759,6395,20091,3335,4769,0,0,2
6/22/21,Terengganu,3552,3405,6957,0,0,127813,76972,204785,2,1,2693,288,834,3116,24,0,0,2
6/22/21,W.P. Kuala Lumpur,34736,5784,40520,4,0,801905,155512,957417,20,0,2182,2784,21275,2996,11279,1,0,3
6/22/21,W.P. Labuan,3047,6,3053,0,0,36115,13480,49595,1,0,3047,6,0,0,0,0,0,0
6/22/21,W.P. Putrajaya,943,811,1754,0,0,35114,21737,56851,0,0,812,311,131,500,0,0,0,0
6/23/21,Johor,9329,8816,18145,0,0,405916,193049,598965,9,0,2741,7014,3410,1802,3178,0,0,0
6/23/21,Kedah,1342,10283,11625,0,0,226123,133957,360080,0,0,1029,4540,313,5741,0,0,0,2
6/23/21,Kelantan,2962,8107,11069,0,0,204572,104356,308928,0,0,2301,2036,629,6065,0,0,0,38
6/23/21,Melaka,4276,2906,7182,0,0,113180,52138,165318,0,0,1028,1320,3248,1586,0,0,0,0
6/23/21,Negeri Sembilan,6187,2751,8938,0,0,153391,78818,232209,2,0,2991,611,3196,2139,0,0,0,1
6/23/21,Pahang,4743,4172,8915,0,0,190509,107731,298240,1,0,2930,3204,1813,967,0,0,0,1
6/23/21,Perak,4307,6982,11289,0,0,297702,166432,464134,2,0,711,733,3584,6249,0,0,0,12
6/23/21,Perlis,1660,2071,3731,0,0,61332,33575,94907,0,0,206,508,1454,1563,0,0,0,0
6/23/21,Pulau Pinang,9910,4318,14228,0,0,239011,97383,336394,8,0,4622,998,2377,3319,2901,0,0,11
6/23/21,Sabah,8066,5610,13676,1,0,357062,142873,499935,10,2,5021,3282,3044,2327,0,0,0,2
6/23/21,Sarawak,60157,437,60594,8,0,826261,195153,1021414,36,0,169,60,59131,377,777,0,0,80
6/23/21,Selangor,31284,11877,43161,1,0,731189,236115,967304,7,0,6980,7080,19619,4793,4682,0,0,7
6/23/21,Terengganu,3523,3862,7385,0,0,131336,80834,212170,2,1,2605,334,917,3521,0,0,0,8
6/23/21,W.P. Kuala Lumpur,33323,5902,39225,8,0,835228,161414,996642,28,0,2388,2657,19560,3241,11368,1,0,10
6/23/21,W.P. Labuan,2430,314,2744,0,0,38545,13794,52339,1,0,2430,314,0,0,0,0,0,0
6/23/21,W.P. Putrajaya,459,1291,1750,0,0,35573,23028,58601,0,0,373,327,86,964,0,0,0,0
6/24/21,Johor,10272,7416,17688,0,0,416188,200465,616653,9,0,3411,4809,3631,2607,3230,0,0,0
6/24/21,Kedah,1800,10639,12439,0,0,227923,144596,372519,0,0,1532,4761,265,5877,0,0,0,4
6/24/21,Kelantan,2095,8534,10629,0,0,206667,112890,319557,0,0,1171,2187,924,6345,0,0,0,2
6/24/21,Melaka,4634,3693,8327,0,0,117814,55831,173645,0,0,2004,1941,2608,1752,22,0,0,0
6/24/21,Negeri Sembilan,5987,3546,9533,0,0,159378,82364,241742,2,0,2661,647,3323,2899,0,0,0,3
6/24/21,Pahang,3107,5860,8967,0,0,193616,113591,307207,1,0,1007,1985,2100,3875,0,0,0,0
6/24/21,Perak,5787,7494,13281,0,0,303489,173926,477415,2,0,1010,473,4762,7018,7,0,0,11
6/24/21,Perlis,986,2225,3211,0,0,62318,35800,98118,0,0,501,2205,485,20,0,0,0,0
6/24/21,Pulau Pinang,9255,5142,14397,1,0,248266,102525,350791,9,0,2930,1281,3463,3860,2862,0,0,1
6/24/21,Sabah,7253,8017,15270,0,0,364315,150890,515205,10,2,3428,4578,3825,3432,0,0,0,7
6/24/21,Sarawak,58897,6614,65511,6,0,885158,201767,1086925,42,0,11,44,57785,6568,980,0,0,123
6/24/21,Selangor,32785,13670,46455,1,0,763974,249785,1013759,8,0,7396,8367,20885,5301,4503,0,0,3
6/24/21,Terengganu,3711,2881,6592,0,0,135047,83715,218762,2,1,2665,207,1008,2674,37,0,0,1
6/24/21,W.P. Kuala Lumpur,32724,6654,39378,3,0,867952,168068,1036020,31,0,1238,3272,20115,3379,11368,3,0,3
6/24/21,W.P. Labuan,2235,472,2707,1,0,40780,14266,55046,2,0,1453,472,779,0,0,0,0,3
6/24/21,W.P. Putrajaya,423,1508,1931,0,0,35996,24536,60532,0,0,305,352,118,1156,0,0,0,0
6/25/21,Johor,7525,1503,9028,1,0,423713,201968,625681,10,0,478,610,3944,893,3103,0,0,0
6/25/21,Kedah,390,4087,4477,0,0,228313,148683,376996,0,0,211,713,179,3374,0,0,0,0
6/25/21,Kelantan,288,460,748,0,0,206955,113350,320305,0,0,1,0,287,460,0,0,0,0
6/25/21,Melaka,5652,3477,9129,0,0,123466,59308,182774,0,0,2209,1171,3432,2305,11,0,0,1
6/25/21,Negeri Sembilan,4794,3207,8001,0,0,164172,85571,249743,2,0,1827,640,2967,2567,0,0,0,0
6/25/21,Pahang,2998,4038,7036,0,0,196614,117629,314243,1,0,1453,1151,1436,2887,109,0,0,0
6/25/21,Perak,2051,8187,10238,0,0,305540,182113,487653,2,0,1266,3412,785,4769,0,0,0,6
6/25/21,Perlis,1357,1198,2555,0,0,63675,36998,100673,0,0,1280,58,77,1140,0,0,0,0
6/25/21,Pulau Pinang,8642,5437,14079,0,0,256908,107962,364870,9,0,2600,1290,3147,4146,2895,0,0,1
6/25/21,Sabah,6753,9240,15993,0,0,371068,160130,531198,10,2,3846,4373,2907,4866,0,0,0,1
6/25/21,Sarawak,50531,7221,57752,0,0,935689,208988,1144677,42,0,589,1629,49009,5584,884,0,0,57
6/25/21,Selangor,32856,11405,44261,2,0,796830,261190,1058020,10,0,9266,6927,19192,4478,4394,0,0,4
6/25/21,Terengganu,85,8,93,0,0,135132,83723,218855,2,1,85,8,0,0,0,0,0,0
6/25/21,W.P. Kuala Lumpur,27371,6670,34041,1,2,895323,174738,1070061,32,2,1736,3578,15108,3087,10525,4,0,3
6/25/21,W.P. Labuan,1886,510,2396,0,0,42666,14776,57442,2,0,1470,410,416,100,0,0,0,0
6/25/21,W.P. Putrajaya,386,1365,1751,0,0,36382,25901,62283,0,0,364,383,22,982,0,0,0,0
6/26/21,Johor,4911,10512,15423,0,0,428624,212480,641104,10,0,2040,9306,950,1205,1920,0,0,2
6/26/21,Kedah,304,3020,3324,0,0,228617,151703,380320,0,0,270,2,34,3018,0,0,0,0
6/26/21,Kelantan,915,656,1571,0,0,207870,114006,321876,0,0,0,655,915,1,0,0,0,0
6/26/21,Melaka,5646,2128,7774,0,0,129112,61436,190548,0,0,1089,604,4557,1524,0,0,0,0
6/26/21,Negeri Sembilan,1213,1074,2287,0,0,165385,86645,252030,2,0,142,439,1071,635,0,0,0,0
6/26/21,Pahang,4245,1857,6102,0,0,200859,119486,320345,1,0,966,0,3279,1857,0,0,0,0
6/26/21,Perak,674,6334,7008,0,0,306214,188447,494661,2,0,529,3730,143,2601,2,0,0,3
6/26/21,Perlis,462,793,1255,0,0,64137,37791,101928,0,0,460,6,2,787,0,0,0,0
6/26/21,Pulau Pinang,7266,3567,10833,0,0,264174,111529,375703,9,0,2747,1136,2241,2431,2278,0,0,0
6/26/21,Sabah,6372,8987,15359,0,0,377440,169117,546557,10,2,3781,5653,2440,3332,151,0,0,2
6/26/21,Sarawak,44587,10481,55068,3,0,980276,219469,1199745,45,0,9895,8732,34327,1747,0,0,0,367
6/26/21,Selangor,31284,6109,37393,2,0,828114,267299,1095413,12,0,8583,3759,18255,2345,4446,0,0,5
6/26/21,Terengganu,6262,379,6641,0,0,141394,84102,225496,2,1,0,0,6262,379,0,0,0,0
6/26/21,W.P. Kuala Lumpur,24414,31,24445,1,0,919737,174769,1094506,33,2,1223,12,13680,19,9511,0,0,0
6/26/21,W.P. Labuan,1783,229,2012,1,0,44449,15005,59454,3,0,1783,227,0,2,0,0,0,0
6/26/21,W.P. Putrajaya,25,0,25,0,0,36407,25901,62308,0,0,0,0,25,0,0,0,0,0
6/27/21,Johor,3309,10838,14147,0,0,431933,223318,655251,10,0,1319,10741,88,97,1902,0,0,0
6/27/21,Kedah,605,10274,10879,0,0,229222,161977,391199,0,0,593,6154,12,4111,0,0,0,9
6/27/21,Kelantan,1884,7040,8924,0,0,209754,121046,330800,0,0,419,5831,1465,1209,0,0,0,0
6/27/21,Melaka,599,0,599,0,0,129711,61436,191147,0,0,599,0,0,0,0,0,0,0
6/27/21,Negeri Sembilan,1132,998,2130,0,0,166517,87643,254160,2,0,358,432,774,566,0,0,0,0
6/27/21,Pahang,409,4026,4435,0,0,201268,123512,324780,1,0,301,0,108,4026,0,0,0,0
6/27/21,Perak,513,6889,7402,0,0,306727,195336,502063,2,0,453,3548,60,3340,0,0,0,1
6/27/21,Perlis,2169,29,2198,0,0,66306,37820,104126,0,0,2168,29,1,0,0,0,0,0
6/27/21,Pulau Pinang,3008,2,3010,0,0,267182,111531,378713,9,0,121,1,991,1,1896,0,0,0
6/27/21,Sabah,3776,6730,10506,0,0,381216,175847,557063,10,2,2226,4298,1550,2432,0,0,0,0
6/27/21,Sarawak,36762,14383,51145,1,0,1017038,233852,1250890,46,0,3122,4154,33640,10228,0,0,0,1
6/27/21,Selangor,27136,1490,28626,5,0,855250,268789,1124039,17,0,5874,14,17393,1476,3868,0,0,1
6/27/21,Terengganu,3963,3094,7057,0,0,145357,87196,232553,2,1,1711,3009,2247,82,0,0,0,8
6/27/21,W.P. Kuala Lumpur,24571,65,24636,0,0,944308,174834,1119142,33,2,1851,42,13944,23,8775,0,0,1
6/27/21,W.P. Labuan,1377,6,1383,0,0,45826,15011,60837,3,0,1377,6,0,0,0,0,0,0
6/27/21,W.P. Putrajaya,13,0,13,0,0,36420,25901,62321,0,0,0,0,13,0,0,0,0,0
6/28/21,Johor,6817,1829,8646,1,0,438750,225147,663897,11,0,2172,528,1838,1301,2807,0,0,0
6/28/21,Kedah,4484,3492,7976,0,0,233706,165469,399175,0,0,4063,1422,421,2070,0,0,0,0
6/28/21,Kelantan,5482,801,6283,0,0,215236,121847,337083,0,0,1997,163,3485,638,0,0,0,0
6/28/21,Melaka,3064,0,3064,1,0,132775,61436,194211,1,0,1267,0,1686,0,110,0,0,1
6/28/21,Negeri Sembilan,7089,656,7745,0,1,173606,88299,261905,2,1,3537,17,3551,639,0,0,0,1
6/28/21,Pahang,7571,170,7741,0,0,208839,123682,332521,1,0,2046,20,5525,150,0,0,0,0
6/28/21,Perak,6339,762,7101,0,0,313066,196098,509164,2,0,686,346,5652,415,1,0,0,1
6/28/21,Perlis,572,2,574,0,0,66878,37822,104700,0,0,530,2,42,0,0,0,0,0
6/28/21,Pulau Pinang,11848,518,12366,0,0,279030,112049,391079,9,0,3334,14,5647,504,2864,0,0,3
6/28/21,Sabah,3452,7188,10640,0,2,384668,183035,567703,10,4,1535,4811,1917,2363,0,0,0,14
6/28/21,Sarawak,40706,13008,53714,0,0,1057744,246860,1304604,46,0,2894,2097,37763,10911,0,0,0,49
6/28/21,Selangor,34532,4896,39428,8,0,889782,273685,1163467,25,0,10732,87,20042,4809,3757,0,0,1
6/28/21,Terengganu,4361,478,4839,1,0,149718,87674,237392,3,1,2019,473,2332,4,10,1,0,0
6/28/21,W.P. Kuala Lumpur,26391,8792,35183,0,0,970699,183626,1154325,33,2,2313,1266,12819,7521,11257,2,0,5
6/28/21,W.P. Labuan,2030,6,2036,0,0,47856,15017,62873,3,0,2030,4,0,2,0,0,0,0
6/28/21,W.P. Putrajaya,521,744,1265,0,0,36941,26645,63586,0,0,426,233,95,511,0,0,0,0
6/29/21,Johor,6477,8815,15292,0,0,445227,233962,679189,11,0,750,6954,2896,1861,2831,0,0,0
6/29/21,Kedah,1411,8583,9994,0,0,235117,174052,409169,0,0,828,6260,582,2322,1,0,0,1
6/29/21,Kelantan,2631,6820,9451,0,0,217867,128667,346534,0,0,759,4218,1872,2600,0,0,0,2
6/29/21,Melaka,3086,3435,6521,0,0,135861,64871,200732,1,0,2148,2101,938,1334,0,0,0,0
6/29/21,Negeri Sembilan,5063,2633,7696,0,0,178669,90932,269601,2,1,977,966,4086,1666,0,0,0,1
6/29/21,Pahang,5133,5181,10314,0,0,213972,128863,342835,1,0,47,4900,5085,280,0,0,0,2
6/29/21,Perak,2969,5623,8592,0,0,316035,201721,517756,2,0,442,5166,2516,456,11,0,0,1
6/29/21,Perlis,279,881,1160,0,0,67157,38703,105860,0,0,85,841,194,40,0,0,0,0
6/29/21,Pulau Pinang,9675,5592,15267,0,0,288705,117641,406346,9,0,2430,2237,4439,3349,2806,0,0,6
6/29/21,Sabah,3374,7929,11303,0,0,388042,190964,579006,10,4,1602,5777,1772,2152,0,0,0,0
6/29/21,Sarawak,41882,6088,47970,1,0,1099626,252948,1352574,47,0,5621,2648,36254,3440,0,0,0,7
6/29/21,Selangor,37131,12079,49210,3,1,926913,285764,1212677,28,1,8205,4272,24853,7806,4073,0,0,1
6/29/21,Terengganu,4018,472,4490,0,0,153736,88146,241882,3,1,1498,404,2519,66,0,0,0,3
6/29/21,W.P. Kuala Lumpur,31499,10232,41731,4,0,1002198,193858,1196056,37,2,2818,1705,17429,8521,11246,3,0,9
6/29/21,W.P. Labuan,2173,280,2453,1,0,50029,15297,65326,4,0,2173,280,0,0,0,0,0,0
6/29/21,W.P. Putrajaya,1164,385,1549,0,0,38105,27030,65135,0,0,658,380,506,5,0,0,0,0
6/30/21,Johor,6860,11205,18065,0,0,452087,245167,697254,11,0,1084,8290,2977,2914,2799,0,0,1
6/30/21,Kedah,1944,6495,8439,0,0,237061,180547,417608,0,0,708,4257,1236,2238,0,0,0,0
6/30/21,Kelantan,3724,7909,11633,0,0,221591,136576,358167,0,0,727,4547,2997,3362,0,0,0,0
6/30/21,Melaka,4821,3527,8348,0,0,140682,68398,209080,1,0,299,2216,4522,1311,0,0,0,0
6/30/21,Negeri Sembilan,5778,3404,9182,0,0,184447,94336,278783,2,1,1687,1436,4091,1967,0,0,0,1
6/30/21,Pahang,4870,5947,10817,0,0,218842,134810,353652,1,0,1209,4839,3661,1097,0,0,0,11
6/30/21,Perak,6322,8166,14488,0,0,322357,209887,532244,2,0,1112,7671,5206,494,3,0,0,2
6/30/21,Perlis,304,1426,1730,0,0,67461,40129,107590,0,0,120,901,184,525,0,0,0,0
6/30/21,Pulau Pinang,9178,6298,15476,0,0,297883,123939,421822,9,0,1826,3755,4530,2542,2820,0,0,3
6/30/21,Sabah,2726,9215,11941,0,0,390768,200179,590947,10,4,1289,7525,1437,1619,0,0,0,71
6/30/21,Sarawak,42291,3781,46072,1,0,1141917,256729,1398646,48,0,398,834,41844,2947,1,0,0,48
6/30/21,Selangor,43059,15948,59007,1,0,969972,301712,1271684,29,1,10166,7486,28576,8459,4317,1,0,2
6/30/21,Terengganu,4117,1948,6065,0,0,157853,90094,247947,3,1,1483,1892,2629,54,0,0,0,7
6/30/21,W.P. Kuala Lumpur,33943,10113,44056,0,0,1036141,203971,1240112,37,2,2893,1705,19723,8404,11327,4,0,0
6/30/21,W.P. Labuan,1932,559,2491,0,0,51961,15856,67817,4,0,1932,324,0,234,0,0,0,1
6/30/21,W.P. Putrajaya,1162,560,1722,0,0,39267,27590,66857,0,0,930,553,232,7,0,0,0,0
7/1/21,Johor,7677,11724,19401,0,0,459764,256891,716655,11,0,710,9939,4153,1785,2814,0,0,0
7/1/21,Kedah,4006,5768,9774,0,0,241067,186315,427382,0,0,534,3889,3472,1879,0,0,0,0
7/1/21,Kelantan,3096,6554,9650,0,0,224687,143130,367817,0,0,839,3474,2256,3080,0,0,0,1
7/1/21,Melaka,5479,2284,7763,0,0,146161,70682,216843,1,0,363,692,5109,1592,0,0,0,7
7/1/21,Negeri Sembilan,6887,4103,10990,0,0,191334,98439,289773,2,1,2629,1528,4254,2574,0,0,0,5
7/1/21,Pahang,3205,4876,8081,0,0,222047,139686,361733,1,0,791,4038,2414,837,0,0,0,1
7/1/21,Perak,10865,5099,15964,0,0,333222,214986,548208,2,0,598,3801,10264,1297,0,0,0,4
7/1/21,Perlis,512,1629,2141,0,0,67973,41758,109731,0,0,334,1595,178,34,0,0,0,0
7/1/21,Pulau Pinang,9208,5046,14254,0,0,307091,128985,436076,9,0,1514,2689,4867,2356,2827,0,0,1
7/1/21,Sabah,3116,7637,10753,0,0,393884,207816,601700,10,4,1744,6352,1372,1281,0,0,0,4
7/1/21,Sarawak,48484,2490,50974,4,0,1190401,259219,1449620,52,0,94,357,48389,2131,0,0,0,3
7/1/21,Selangor,39342,15752,55094,1,0,1009314,317464,1326778,30,1,10709,5488,24165,10262,4466,2,0,2
7/1/21,Terengganu,4456,734,5190,0,0,162309,90828,253137,3,1,1121,632,3251,96,84,1,0,5
7/1/21,W.P. Kuala Lumpur,33969,11561,45530,2,1,1070110,215532,1285642,39,3,2705,2400,20066,9154,11195,6,0,4
7/1/21,W.P. Labuan,1501,568,2069,1,0,53462,16424,69886,5,0,1496,288,5,279,0,0,0,1
7/1/21,W.P. Putrajaya,1303,435,1738,0,0,40570,28025,68595,0,0,1101,295,202,140,0,0,0,0
7/2/21,Johor,6906,2553,9459,0,0,466670,259444,726114,11,0,666,1162,3278,1391,2962,0,0,0
7/2/21,Kedah,3045,2251,5296,0,0,244112,188566,432678,0,0,641,562,2404,1689,0,0,0,0
7/2/21,Kelantan,602,440,1042,0,0,225289,143570,368859,0,0,378,0,224,440,0,0,0,0
7/2/21,Melaka,5763,2093,7856,0,0,151924,72775,224699,1,0,219,285,5544,1808,0,0,0,0
7/2/21,Negeri Sembilan,6927,3709,10636,1,0,198261,102148,300409,3,1,2443,1062,4480,2646,0,0,0,5
7/2/21,Pahang,3366,3624,6990,0,0,225413,143310,368723,1,0,1037,2605,2329,1019,0,0,0,0
7/2/21,Perak,14614,4796,19410,0,1,347836,219782,567618,2,1,682,4224,13930,571,0,0,0,3
7/2/21,Perlis,734,980,1714,0,0,68707,42738,111445,0,0,605,646,129,334,0,0,0,0
7/2/21,Pulau Pinang,9337,6425,15762,0,0,316428,135410,451838,9,0,1786,3324,4657,3100,2894,0,0,1
7/2/21,Sabah,1279,10471,11750,0,0,395163,218287,613450,10,4,940,8683,339,1786,0,0,0,2
7/2/21,Sarawak,36420,5297,41717,0,0,1226821,264516,1491337,52,0,487,1010,35933,4287,0,0,0,0
7/2/21,Selangor,38972,14676,53648,0,0,1048286,332140,1380426,30,1,12806,4762,21298,9913,4867,1,0,1
7/2/21,Terengganu,1217,23,1240,0,0,163526,90851,254377,3,1,120,23,1097,0,0,0,0,0
7/2/21,W.P. Kuala Lumpur,38094,12226,50320,0,0,1108204,227758,1335962,39,3,3079,1207,23759,11007,11255,12,0,1
7/2/21,W.P. Labuan,1016,362,1378,0,0,54478,16786,71264,5,0,1016,167,0,195,0,0,0,0
7/2/21,W.P. Putrajaya,1381,402,1783,0,0,41951,28427,70378,0,0,1262,269,119,133,0,0,0,0
7/3/21,Johor,4105,8158,12263,0,1,470775,267602,738377,11,1,418,8108,1751,49,1936,0,0,1
7/3/21,Kedah,5167,1662,6829,0,0,249279,190228,439507,0,0,3676,584,1491,1078,0,0,0,0
7/3/21,Kelantan,408,230,638,0,0,225697,143800,369497,0,0,288,42,120,188,0,0,0,0
7/3/21,Melaka,5299,2035,7334,0,0,157223,74810,232033,1,0,695,607,4604,1428,0,0,0,0
7/3/21,Negeri Sembilan,3143,1161,4304,0,0,201404,103309,304713,3,1,574,282,2569,879,0,0,0,0
7/3/21,Pahang,4174,1320,5494,0,0,229587,144630,374217,1,0,79,774,4095,546,0,0,0,0
7/3/21,Perak,13366,4219,17585,0,0,361202,224001,585203,2,1,585,4153,12769,65,0,0,0,13
7/3/21,Perlis,463,1,464,0,0,69170,42739,111909,0,0,1,0,462,1,0,0,0,0
7/3/21,Pulau Pinang,7057,3972,11029,0,0,323485,139382,462867,9,0,536,2134,4644,1838,1877,0,0,0
7/3/21,Sabah,1335,10691,12026,0,1,396498,228978,625476,10,5,653,8555,682,2132,0,0,0,4
7/3/21,Sarawak,28064,22139,50203,3,1,1254885,286655,1541540,55,1,6481,9201,21528,12921,55,0,0,17
7/3/21,Selangor,32468,9260,41728,1,0,1080754,341400,1422154,31,1,9317,1937,19154,7322,3997,0,0,1
7/3/21,Terengganu,7031,1679,8710,0,0,170557,92530,263087,3,1,1,1186,7030,493,0,0,0,0
7/3/21,W.P. Kuala Lumpur,30504,11624,42128,1,0,1138708,239382,1378090,40,3,920,671,18855,10946,10729,7,0,0
7/3/21,W.P. Labuan,962,395,1357,0,0,55440,17181,72621,5,0,962,393,0,2,0,0,0,0
7/3/21,W.P. Putrajaya,939,1,940,0,0,42890,28428,71318,0,0,714,1,225,0,0,0,0,0
7/4/21,Johor,3759,11006,14765,0,1,474534,278608,753142,11,2,632,10991,1062,15,2065,0,0,0
7/4/21,Kedah,6485,5260,11745,0,0,255764,195488,451252,0,0,4454,4349,2031,911,0,0,0,0
7/4/21,Kelantan,5266,5150,10416,0,0,230963,148950,379913,0,0,386,3711,4880,1439,0,0,0,0
7/4/21,Melaka,0,0,0,0,0,157223,74810,232033,1,0,0,0,0,0,0,0,0,0
7/4/21,Negeri Sembilan,3519,887,4406,0,0,204923,104196,309119,3,1,905,243,2614,644,0,0,0,0
7/4/21,Pahang,573,1388,1961,0,0,230160,146018,376178,1,0,177,1387,396,1,0,0,0,0
7/4/21,Perak,12157,3887,16044,0,0,373359,227888,601247,2,1,1975,3638,10182,249,0,0,0,0
7/4/21,Perlis,416,0,416,0,0,69586,42739,112325,0,0,1,0,415,0,0,0,0,0
7/4/21,Pulau Pinang,7143,4,7147,0,0,330628,139386,470014,9,0,1258,4,3989,0,1896,0,0,0
7/4/21,Sabah,556,7921,8477,0,0,397054,236899,633953,10,5,519,7388,37,533,0,0,0,0
7/4/21,Sarawak,19394,22060,41454,0,0,1274279,308715,1582994,55,1,3322,7376,16017,14684,55,0,0,0
7/4/21,Selangor,35859,6185,42044,0,0,1116613,347585,1464198,31,1,9936,50,21617,6135,4306,0,0,0
7/4/21,Terengganu,5296,3693,8989,0,0,175853,96223,272076,3,1,890,2431,4405,1258,0,0,0,5
7/4/21,W.P. Kuala Lumpur,32421,12646,45067,1,0,1171129,252028,1423157,41,3,1066,873,20759,11769,10591,4,0,5
7/4/21,W.P. Labuan,947,13,960,0,0,56387,17194,73581,5,0,922,11,25,2,0,0,0,0
7/4/21,W.P. Putrajaya,985,0,985,0,0,43875,28428,72303,0,0,738,0,247,0,0,0,0,0
7/5/21,Johor,6875,12315,19190,0,0,481409,290923,772332,11,2,751,10722,3096,1593,3028,0,0,0
7/5/21,Kedah,8933,4222,13155,0,0,264697,199710,464407,0,0,1347,3508,7586,712,0,0,0,2
7/5/21,Kelantan,6031,6563,12594,0,0,236994,155513,392507,0,0,73,4183,5958,2380,0,0,0,0
7/5/21,Melaka,6282,1572,7854,0,0,163505,76382,239887,1,0,762,338,5520,1234,0,0,0,0
7/5/21,Negeri Sembilan,8221,4621,12842,0,0,213144,108817,321961,3,1,884,1344,7337,3275,0,0,0,2
7/5/21,Pahang,7011,3026,10037,2,0,237171,149044,386215,3,0,3524,2704,3487,322,0,0,0,0
7/5/21,Perak,16790,5843,22633,0,0,390149,233731,623880,2,1,2032,5392,14755,450,0,0,0,4
7/5/21,Perlis,672,1885,2557,0,0,70258,44624,114882,0,0,52,1820,620,65,0,0,0,0
7/5/21,Pulau Pinang,10676,4936,15612,0,0,341304,144322,485626,9,0,866,4154,6931,782,2879,0,0,0
7/5/21,Sabah,1513,10493,12006,0,0,398567,247392,645959,10,5,764,7697,749,2795,0,0,0,1
7/5/21,Sarawak,30196,28557,58753,0,1,1304475,337272,1641747,55,2,1081,1467,29094,27054,0,0,0,57
7/5/21,Selangor,54232,19076,73308,0,0,1170845,366661,1537506,31,1,14769,4411,34795,14433,4668,232,0,0
7/5/21,Terengganu,6176,4170,10346,0,0,182029,100393,282422,3,1,757,2848,5412,1313,0,0,0,16
7/5/21,W.P. Kuala Lumpur,40030,11192,51222,1,0,1211159,263220,1474379,42,3,4861,1604,24112,9122,11057,466,0,0
7/5/21,W.P. Labuan,655,1068,1723,0,0,57042,18262,75304,5,0,655,1065,0,3,0,0,0,0
7/5/21,W.P. Putrajaya,1808,431,2239,0,0,45683,28859,74542,0,0,1403,424,405,7,0,0,0,0
7/6/21,Johor,8270,10190,18460,1,0,489679,301113,790792,12,2,768,7990,4460,2200,3041,0,0,1
7/6/21,Kedah,8732,4249,12981,0,0,273429,203959,477388,0,0,693,3390,8038,857,0,0,0,3
7/6/21,Kelantan,6559,8294,14853,0,0,243553,163807,407360,0,0,1216,4611,5342,3606,0,0,0,78
7/6/21,Melaka,6439,2035,8474,0,0,169944,78417,248361,1,0,2045,906,4394,1129,0,0,0,0
7/6/21,Negeri Sembilan,10189,5330,15519,0,1,223333,114147,337480,3,2,1435,2780,8752,2548,0,0,0,4
7/6/21,Pahang,4666,5973,10639,0,0,241837,155017,396854,3,0,1108,5269,3558,704,0,0,0,0
7/6/21,Perak,14739,6205,20944,0,0,404888,239936,644824,2,1,2035,5339,12697,866,0,0,0,7
7/6/21,Perlis,1350,1804,3154,0,0,71608,46428,118036,0,0,71,1715,1279,89,0,0,0,0
7/6/21,Pulau Pinang,10410,5563,15973,0,0,351714,149885,501599,9,0,870,4893,6655,668,2885,0,0,2
7/6/21,Sabah,2202,10264,12466,0,0,400769,257656,658425,10,5,1364,7229,838,3013,0,0,0,22
7/6/21,Sarawak,28902,34651,63553,1,1,1333377,371923,1705300,56,3,1457,1566,27445,33081,0,0,0,4
7/6/21,Selangor,64608,22575,87183,1,0,1235453,389236,1624689,32,1,17242,5234,42482,17332,4882,7,0,4
7/6/21,Terengganu,6816,4324,11140,0,0,188845,104717,293562,3,1,725,2936,6089,1379,0,0,0,11
7/6/21,W.P. Kuala Lumpur,39657,14334,53991,2,0,1250816,277554,1528370,44,3,5187,2238,23503,12087,10966,9,0,1
7/6/21,W.P. Labuan,644,931,1575,0,0,57686,19193,76879,5,0,638,424,5,506,0,0,0,2
7/6/21,W.P. Putrajaya,1984,720,2704,0,0,47667,29579,77246,0,0,1376,676,608,44,0,0,0,0
7/7/21,Johor,8733,14162,22895,1,0,498412,315275,813687,13,2,1299,11315,4471,2847,2963,0,0,0
7/7/21,Kedah,11110,3942,15052,0,0,284539,207901,492440,0,0,912,3018,10198,923,0,0,0,1
7/7/21,Kelantan,5429,11483,16912,0,0,248982,175290,424272,0,0,898,5368,4530,6036,0,0,0,80
7/7/21,Melaka,4799,4670,9469,0,0,174743,83087,257830,1,0,1469,2167,3330,2503,0,0,0,0
7/7/21,Negeri Sembilan,17458,5574,23032,0,0,240791,119721,360512,3,2,10436,2799,7022,2772,0,0,0,3
7/7/21,Pahang,6888,5172,12060,0,0,248725,160189,408914,3,0,1195,4348,5693,823,0,0,0,1
7/7/21,Perak,20445,2605,23050,0,0,425333,242541,667874,2,1,2281,1746,18162,858,0,0,0,3
7/7/21,Perlis,1808,2598,4406,0,0,73416,49026,122442,0,0,651,2486,1157,112,0,0,0,0
7/7/21,Pulau Pinang,8114,5132,13246,1,0,359828,155017,514845,10,0,234,3956,5004,1176,2876,0,0,0
7/7/21,Sabah,1735,11767,13502,0,2,402504,269423,671927,10,7,665,7048,1070,4717,0,0,0,2
7/7/21,Sarawak,30467,49248,79715,2,5,1363844,421171,1785015,58,8,385,1258,30082,47828,0,0,0,162
7/7/21,Selangor,56530,30994,87524,9,0,1291983,420230,1712213,41,1,12899,7330,38924,22646,4704,1018,0,3
7/7/21,Terengganu,6455,4431,10886,0,0,195300,109148,304448,3,1,380,3103,6073,1321,0,0,0,9
7/7/21,W.P. Kuala Lumpur,36369,20959,57328,4,0,1287185,298513,1585698,48,3,4495,4676,20882,12939,10992,3343,0,1
7/7/21,W.P. Labuan,529,1097,1626,0,0,58215,20290,78505,5,0,496,1097,33,0,0,0,0,0
7/7/21,W.P. Putrajaya,1389,1177,2566,0,0,49056,30756,79812,0,0,996,1097,393,80,0,0,0,0
7/8/21,Johor,11766,11899,23665,1,0,510178,327174,837352,14,2,2300,9026,6409,2868,3056,0,0,6
7/8/21,Kedah,11606,4118,15724,0,0,296145,212019,508164,0,0,1753,3632,9852,486,0,0,0,1
7/8/21,Kelantan,5697,8968,14665,0,0,254679,184258,438937,0,0,200,4520,5497,4448,0,0,0,0
7/8/21,Melaka,6375,2768,9143,0,0,181118,85855,266973,1,0,236,1475,6134,1293,0,0,0,5
7/8/21,Negeri Sembilan,17659,5216,22875,1,0,258450,124937,383387,4,2,9625,2546,8034,2668,0,0,0,2
7/8/21,Pahang,7833,3403,11236,0,0,256558,163592,420150,3,0,749,2005,7084,1398,0,0,0,0
7/8/21,Perak,12946,9201,22147,1,0,438279,251742,690021,3,1,948,8368,11996,832,0,0,0,3
7/8/21,Perlis,1924,1385,3309,0,0,75340,50411,125751,0,0,62,1284,1862,100,0,0,0,1
7/8/21,Pulau Pinang,10011,7499,17510,1,1,369839,162516,532355,11,1,753,6265,6351,1231,2907,2,0,1
7/8/21,Sabah,2026,9943,11969,1,0,404530,279366,683896,11,7,692,5881,1334,4054,0,0,0,8
7/8/21,Sarawak,29047,46426,75473,7,0,1392891,467597,1860488,65,8,26,1326,28995,45099,0,0,0,27
7/8/21,Selangor,66742,25245,91987,1,0,1358725,445475,1804200,42,1,15926,4997,46006,19189,4810,1054,0,5
7/8/21,Terengganu,6393,3278,9671,0,0,201693,112426,314119,3,1,192,2139,6197,1138,0,0,0,5
7/8/21,W.P. Kuala Lumpur,37058,16385,53443,2,0,1324243,314898,1639141,50,3,5217,2721,20998,11376,10816,2288,0,27
7/8/21,W.P. Labuan,456,2259,2715,0,0,58671,22549,81220,5,0,454,1592,2,667,0,0,0,0
7/8/21,W.P. Putrajaya,1625,898,2523,0,0,50681,31654,82335,0,0,1310,833,315,65,0,0,0,0
7/9/21,Johor,11458,4090,15548,0,0,521636,331264,852900,14,2,27,1619,8371,2471,3060,0,0,0
7/9/21,Kedah,4800,1646,6446,0,0,300945,213665,514610,0,0,571,1267,4229,379,0,0,0,0
7/9/21,Kelantan,17,430,447,0,0,254696,184688,439384,0,0,6,1,11,429,0,0,0,0
7/9/21,Melaka,6280,2570,8850,1,0,187398,88425,275823,2,0,205,1523,6073,1047,0,0,0,2
7/9/21,Negeri Sembilan,17345,4000,21345,0,0,275795,128937,404732,4,2,9115,2065,8230,1935,0,0,0,0
7/9/21,Pahang,3838,3417,7255,0,0,260396,167009,427405,3,0,631,2338,3207,1079,0,0,0,0
7/9/21,Perak,18111,7943,26054,1,0,456390,259685,716075,4,1,1303,7439,16802,504,0,0,0,6
7/9/21,Perlis,1483,898,2381,0,0,76823,51309,128132,0,0,139,357,1343,541,0,0,0,1
7/9/21,Pulau Pinang,10912,5817,16729,0,0,380751,168333,549084,11,1,1033,4649,6909,1168,2970,0,0,0
7/9/21,Sabah,3473,11257,14730,0,0,408003,290623,698626,11,7,894,7689,2579,3556,0,0,0,12
7/9/21,Sarawak,25111,44765,69876,7,0,1418002,512362,1930364,72,8,842,1111,24269,43644,0,0,0,10
7/9/21,Selangor,74557,22679,97236,6,0,1433282,468154,1901436,48,1,20830,5094,48615,16523,5109,1061,0,4
7/9/21,Terengganu,2510,5,2515,0,0,204203,112431,316634,3,1,12,5,2498,0,0,0,0,0
7/9/21,W.P. Kuala Lumpur,37962,15555,53517,1,0,1362205,330453,1692658,51,3,6009,2472,21185,10706,10768,2373,0,4
7/9/21,W.P. Labuan,383,2232,2615,1,0,59054,24781,83835,6,0,354,2230,29,2,0,0,0,0
7/9/21,W.P. Putrajaya,1753,681,2434,0,0,52434,32335,84769,0,0,1402,674,351,7,0,0,0,0
7/10/21,Johor,19668,6423,26091,1,0,541304,337687,878991,15,2,1425,5605,16185,817,2057,1,0,1
7/10/21,Kedah,4437,240,4677,0,0,305382,213905,519287,0,0,2098,215,2338,25,0,0,0,1
7/10/21,Kelantan,671,547,1218,0,0,255367,185235,440602,0,0,0,0,671,547,0,0,0,0
7/10/21,Melaka,3817,4974,8791,0,0,191215,93399,284614,2,0,1532,3310,2285,1663,0,0,0,1
7/10/21,Negeri Sembilan,19471,1247,20718,1,0,295266,130184,425450,5,2,12961,388,6510,859,0,0,0,0
7/10/21,Pahang,5682,454,6136,0,0,266078,167463,433541,3,0,168,413,5514,41,0,0,0,0
7/10/21,Perak,18128,5976,24104,0,0,474518,265661,740179,4,1,175,5837,17946,139,0,0,0,7
7/10/21,Perlis,771,1837,2608,0,0,77594,53146,130740,0,0,2,1385,769,451,0,0,0,1
7/10/21,Pulau Pinang,5925,6042,11967,0,0,386676,174375,561051,11,1,58,4106,3882,1933,1985,1,0,2
7/10/21,Sabah,4403,11827,16230,1,0,412406,302450,714856,12,7,452,7836,3946,3988,0,0,0,8
7/10/21,Sarawak,28482,38588,67070,5,2,1446484,550950,1997434,77,10,5437,15017,23045,23561,0,0,0,10
7/10/21,Selangor,63021,16166,79187,4,0,1496303,484320,1980623,52,1,21208,1906,37540,13184,4273,1075,0,1
7/10/21,Terengganu,11774,894,12668,0,2,215977,113325,329302,3,3,7,0,11767,894,0,0,0,0
7/10/21,W.P. Kuala Lumpur,30385,17209,47594,1,0,1392590,347662,1740252,52,3,3726,1608,16526,13178,10133,2423,0,0
7/10/21,W.P. Labuan,373,2151,2524,0,0,59427,26932,86359,6,0,372,1644,1,507,0,0,0,0
7/10/21,W.P. Putrajaya,2216,0,2216,0,0,54650,32335,86985,0,0,1849,0,367,0,0,0,0,0
7/11/21,Johor,13546,5719,19265,1,0,554850,343406,898256,16,2,3231,4680,8336,1038,1978,0,0,2
7/11/21,Kedah,7106,963,8069,0,0,312488,214868,527356,0,0,6326,941,779,21,0,0,0,2
7/11/21,Kelantan,6725,4584,11309,0,0,262092,189819,451911,0,0,4275,3451,2450,1132,0,0,0,1
7/11/21,Melaka,30,0,30,0,0,191245,93399,284644,2,0,0,0,30,0,0,0,0,0
7/11/21,Negeri Sembilan,17844,589,18433,0,0,313110,130773,443883,5,2,11166,13,6678,576,0,0,0,0
7/11/21,Pahang,5328,800,6128,0,0,271406,168263,439669,3,0,0,1,5328,799,0,0,0,0
7/11/21,Perak,14031,5281,19312,0,0,488549,270942,759491,4,1,73,4316,13954,963,0,0,0,6
7/11/21,Perlis,511,2114,2625,0,0,78105,55260,133365,0,0,1,1640,510,474,0,0,0,0
7/11/21,Pulau Pinang,10314,478,10792,0,0,396990,174853,571843,11,1,67,10,8250,467,1996,1,0,1
7/11/21,Sabah,6281,7559,13840,0,0,418687,310009,728696,12,7,1188,5706,5093,1853,0,0,0,0
7/11/21,Sarawak,21069,37925,58994,1,0,1467553,588875,2056428,78,10,4144,10653,16925,27209,0,0,0,63
7/11/21,Selangor,52153,12449,64602,0,0,1548456,496769,2045225,52,1,12753,9,35116,11428,4284,1012,0,0
7/11/21,Terengganu,6614,3095,9709,0,0,222591,116420,339011,3,3,898,2440,5716,652,0,0,0,3
7/11/21,W.P. Kuala Lumpur,29616,19661,49277,4,0,1422206,367323,1789529,56,3,4163,1805,15346,15445,10107,2410,0,1
7/11/21,W.P. Labuan,585,1689,2274,0,0,60012,28621,88633,6,0,585,1676,0,13,0,0,0,0
7/11/21,W.P. Putrajaya,2238,0,2238,0,0,56888,32335,89223,0,0,1813,0,425,0,0,0,0,0
7/12/21,Johor,16482,5429,21911,1,0,571332,348835,920167,17,2,4163,2620,9333,2808,2986,0,0,1
7/12/21,Kedah,13300,3436,16736,0,0,325788,218304,544092,0,0,3586,3332,9714,89,0,0,0,15
7/12/21,Kelantan,9830,4664,14494,1,0,271922,194483,466405,1,0,4394,3687,5434,977,0,0,0,2
7/12/21,Melaka,6025,4388,10413,1,0,197270,97787,295057,3,0,726,996,5299,3392,0,0,0,0
7/12/21,Negeri Sembilan,15536,5076,20612,1,0,328646,135849,464495,6,2,11613,2739,3908,2336,0,0,0,16
7/12/21,Pahang,6634,6138,12772,0,0,278040,174401,452441,3,0,2250,3915,4384,2223,0,0,0,0
7/12/21,Perak,18397,6573,24970,1,0,506946,277515,784461,5,1,1337,2086,17060,4482,0,0,0,5
7/12/21,Perlis,1042,1760,2802,0,0,79147,57020,136167,0,0,76,1495,966,265,0,0,0,0
7/12/21,Pulau Pinang,10558,7302,17860,0,0,407548,182155,589703,11,1,630,5282,7216,2019,2711,0,0,2
7/12/21,Sabah,7731,8793,16524,3,1,426418,318802,745220,15,8,393,5834,7338,2957,0,0,0,2
7/12/21,Sarawak,31467,55772,87239,22,1,1499020,644647,2143667,100,11,411,833,31045,54939,1,0,0,10
7/12/21,Selangor,76671,22930,99601,4,0,1625127,519699,2144826,56,1,31448,5004,40579,16878,4643,1046,0,3
7/12/21,Terengganu,8306,3816,12122,0,0,230897,120236,351133,3,3,1212,2940,7073,869,0,0,0,28
7/12/21,W.P. Kuala Lumpur,46178,22155,68333,6,1,1468384,389478,1857862,62,4,10404,1819,25024,17965,10749,2367,0,5
7/12/21,W.P. Labuan,464,2444,2908,1,0,60476,31065,91541,7,0,464,2429,0,13,0,0,0,2
7/12/21,W.P. Putrajaya,1982,796,2778,0,0,58870,33131,92001,0,0,1159,774,823,22,0,0,0,0
7/13/21,Johor,16947,6085,23032,1,0,588279,354920,943199,18,2,3830,3154,9948,2931,3169,0,0,0
7/13/21,Kedah,16876,2769,19645,2,0,342664,221073,563737,2,0,3289,2502,13586,267,0,0,0,1
7/13/21,Kelantan,12253,4074,16327,2,0,284175,198557,482732,3,0,1294,3071,10957,905,0,0,0,100
7/13/21,Melaka,6792,3961,10753,2,0,204062,101748,305810,5,0,600,2075,6192,1878,0,0,0,8
7/13/21,Negeri Sembilan,17060,6754,23814,3,0,345706,142603,488309,9,2,13117,3640,3937,3113,0,0,0,7
7/13/21,Pahang,5933,7071,13004,0,1,283973,181472,465445,3,1,1473,4642,4460,2428,0,0,0,1
7/13/21,Perak,5115,6115,11230,1,0,512061,283630,795691,6,1,1326,805,3789,5303,0,0,0,7
7/13/21,Perlis,1909,1713,3622,0,0,81056,58733,139789,0,0,221,491,1688,1220,0,0,0,2
7/13/21,Pulau Pinang,13164,7222,20386,0,1,420712,189377,610089,11,2,845,3831,9328,3389,2991,0,0,2
7/13/21,Sabah,10420,9867,20287,9,0,436838,328669,765507,24,8,557,6629,9862,3237,0,0,0,2
7/13/21,Sarawak,24782,57441,82223,13,14,1523802,702088,2225890,113,25,240,589,24495,56852,0,0,0,47
7/13/21,Selangor,76788,25748,102536,1,1,1701915,545447,2247362,57,2,30943,6661,44069,18166,1774,920,0,3
7/13/21,Terengganu,8678,3446,12124,7,0,239575,123682,363257,10,3,565,2633,8103,810,0,0,0,13
7/13/21,W.P. Kuala Lumpur,47432,23842,71274,7,0,1515816,413320,1929136,69,4,10027,2034,26780,19238,10620,2570,0,5
7/13/21,W.P. Labuan,363,2698,3061,0,0,60839,33763,94602,7,0,363,2690,0,8,0,0,0,0
7/13/21,W.P. Putrajaya,2222,927,3149,0,0,61092,34058,95150,0,0,1370,799,852,128,0,0,0,0
7/14/21,Johor,15723,5875,21598,1,0,604002,360795,964797,19,2,4636,2488,8120,3387,2966,0,0,1
7/14/21,Kedah,19934,1237,21171,1,0,362598,222310,584908,3,0,2793,920,17139,317,0,0,0,2
7/14/21,Kelantan,13669,3121,16790,0,0,297844,201678,499522,3,0,576,2421,13084,697,0,0,0,12
7/14/21,Melaka,6933,3821,10754,1,0,210995,105569,316564,6,0,424,629,6509,3192,0,0,0,0
7/14/21,Negeri Sembilan,17895,6701,24596,0,0,363601,149304,512905,9,2,14302,3531,3588,3169,0,0,0,6
7/14/21,Pahang,9041,5000,14041,1,0,293014,186472,479486,4,1,3555,3097,5486,1903,0,0,0,0
7/14/21,Perak,5482,5086,10568,1,0,517543,288716,806259,7,1,1194,1583,4287,3495,0,0,0,9
7/14/21,Perlis,2210,1539,3749,0,0,83266,60272,143538,0,0,769,109,1441,1430,0,0,0,0
7/14/21,Pulau Pinang,17595,6980,24575,1,0,438307,196357,634664,12,2,902,4560,13539,2410,3151,0,0,13
7/14/21,Sabah,10446,8705,19151,1,1,447284,337374,784658,25,9,1278,5642,9164,3058,0,0,0,9
7/14/21,Sarawak,22987,57802,80789,14,7,1546789,759890,2306679,127,32,8,270,22975,57449,0,0,0,87
7/14/21,Selangor,91362,27034,118396,3,0,1793277,572481,2365758,60,2,37124,6816,49557,19265,4669,952,0,13
7/14/21,Terengganu,8442,3472,11914,0,0,248017,127154,375171,10,3,460,2560,7966,900,0,0,0,28
7/14/21,W.P. Kuala Lumpur,48788,22469,71257,7,2,1564604,435789,2000393,76,6,11603,2387,26965,17704,10218,2375,0,5
7/14/21,W.P. Labuan,449,2271,2720,0,0,61288,36034,97322,7,0,433,2266,16,4,0,0,0,1
7/14/21,W.P. Putrajaya,2435,446,2881,0,0,63527,34504,98031,0,0,1771,365,664,79,0,0,0,2
7/15/21,Johor,23477,7016,30493,1,0,627479,367811,995290,20,2,14017,3524,6474,3490,2986,2,0,0
7/15/21,Kedah,19493,1646,21139,0,0,382091,223956,606047,3,0,3077,1378,16414,265,0,0,0,5
7/15/21,Kelantan,15510,2124,17634,0,0,313354,203802,517156,3,0,358,1164,15151,959,0,0,0,2
7/15/21,Melaka,8628,5172,13800,0,0,219623,110741,330364,6,0,765,2637,7863,2534,0,0,0,1
7/15/21,Negeri Sembilan,18581,6657,25238,0,0,382182,155961,538143,9,2,14950,3498,3630,3156,0,0,0,4
7/15/21,Pahang,11230,3725,14955,0,0,304244,190197,494441,4,1,2687,1686,8541,2038,0,0,0,3
7/15/21,Perak,11387,5685,17072,0,0,528930,294401,823331,7,1,7658,1044,3725,4641,0,0,0,4
7/15/21,Perlis,3395,1243,4638,0,0,86661,61515,148176,0,0,3394,764,1,479,0,0,0,0
7/15/21,Pulau Pinang,19308,6288,25596,0,0,457615,202645,660260,12,2,1697,2934,14500,3353,3111,1,0,0
7/15/21,Sabah,11060,8571,19631,4,0,458344,345945,804289,29,9,2348,4296,8711,4275,0,0,0,1
7/15/21,Sarawak,21500,57114,78614,8,4,1568289,817004,2385293,135,36,9,320,21491,56576,0,0,0,218
7/15/21,Selangor,88539,27713,116252,4,0,1881816,600194,2482010,64,2,36099,7370,46740,20338,5697,3,0,5
7/15/21,Terengganu,8487,3601,12088,1,0,256504,130755,387259,11,3,302,2609,8176,988,0,0,0,13
7/15/21,W.P. Kuala Lumpur,51929,20683,72612,8,0,1616533,456472,2073005,84,6,11649,1249,28776,19409,11495,19,0,15
7/15/21,W.P. Labuan,482,2026,2508,0,0,61770,38060,99830,7,0,476,1345,6,681,0,0,0,0
7/15/21,W.P. Putrajaya,2229,423,2652,0,0,65756,34927,100683,0,0,1824,301,405,122,0,0,0,0
7/16/21,Johor,13640,4391,18031,0,0,641119,372202,1013321,20,2,6061,469,4516,3922,3063,0,0,0
7/16/21,Kedah,11537,616,12153,0,0,393628,224572,618200,3,0,2323,447,9214,169,0,0,0,0
7/16/21,Kelantan,1785,411,2196,0,0,315139,204213,519352,3,0,906,0,879,411,0,0,0,0
7/16/21,Melaka,7401,5432,12833,0,0,227024,116173,343197,6,0,1249,2033,6152,3399,0,0,0,0
7/16/21,Negeri Sembilan,18197,4720,22917,0,0,400379,160681,561060,9,2,14483,1808,3713,2912,0,0,0,1
7/16/21,Pahang,9424,3674,13098,3,0,313668,193871,507539,7,1,1434,2228,7990,1423,0,22,0,1
7/16/21,Perak,18584,2175,20759,1,0,547514,296576,844090,8,1,9902,1284,8682,889,0,0,0,2
7/16/21,Perlis,1719,1681,3400,0,0,88380,63196,151576,0,0,1719,1610,0,71,0,0,0,0
7/16/21,Pulau Pinang,18095,5748,23843,1,0,475710,208393,684103,13,2,2127,2625,13186,3123,2781,0,0,1
7/16/21,Sabah,12841,8553,21394,3,0,471185,354498,825683,32,9,3935,6011,8822,2542,0,0,0,84
7/16/21,Sarawak,22720,48931,71651,27,0,1591009,865935,2456944,162,36,640,598,22080,48218,0,0,0,115
7/16/21,Selangor,88151,27649,115800,7,0,1969967,627843,2597810,71,2,34291,8942,48133,18683,5725,19,0,7
7/16/21,Terengganu,2398,78,2476,0,0,258902,130833,389735,11,3,1661,78,737,0,0,0,0,0
7/16/21,W.P. Kuala Lumpur,52737,16504,69241,7,0,1669270,472976,2142246,91,6,12862,1863,28905,14614,10967,23,0,7
7/16/21,W.P. Labuan,326,1965,2291,0,0,62096,40025,102121,7,0,323,1554,3,411,0,0,0,0
7/16/21,W.P. Putrajaya,2145,398,2543,0,0,67901,35325,103226,0,0,1711,372,433,26,0,0,0,1
7/17/21,Johor,19020,3253,22273,2,0,660139,375455,1035594,22,2,14491,2053,2537,1200,1992,0,0,0
7/17/21,Kedah,12875,378,13253,3,0,406503,224950,631453,6,0,6935,347,5939,31,0,0,0,1
7/17/21,Kelantan,1595,589,2184,0,0,316734,204802,521536,3,0,871,1,724,588,0,0,0,0
7/17/21,Melaka,7206,5940,13146,1,0,234230,122113,356343,7,0,1522,1425,5684,4515,0,0,0,0
7/17/21,Negeri Sembilan,17987,1220,19207,7,0,418366,161901,580267,16,2,14720,160,3267,1059,0,0,0,1
7/17/21,Pahang,3725,3045,6770,0,0,317393,196916,514309,7,1,1863,195,1862,2850,0,0,0,0
7/17/21,Perak,14091,605,14696,3,0,561605,297181,858786,11,1,1516,522,12482,83,0,0,0,93
7/17/21,Perlis,194,2,196,0,0,88574,63198,151772,0,0,194,0,0,2,0,0,0,0
7/17/21,Pulau Pinang,14163,5022,19185,1,0,489873,213415,703288,14,2,259,2797,11994,2224,1909,1,0,1
7/17/21,Sabah,14866,8559,23425,4,0,486051,363057,849108,36,9,4459,5684,10370,2875,0,0,0,37
7/17/21,Sarawak,23791,44368,68159,27,2,1614800,910303,2525103,189,38,8310,10320,15400,33934,0,0,0,195
7/17/21,Selangor,78406,25823,104229,11,0,2048373,653666,2702039,82,2,25422,8366,48551,16525,4432,931,0,2
7/17/21,Terengganu,10029,6171,16200,2,0,268931,137004,405935,13,3,8865,1,1164,6170,0,0,0,0
7/17/21,W.P. Kuala Lumpur,41281,23394,64675,14,0,1710551,496370,2206921,105,6,5153,1171,25877,13813,10251,8410,0,0
7/17/21,W.P. Labuan,394,1731,2125,0,1,62490,41756,104246,7,1,394,1691,0,40,0,0,0,0
7/17/21,W.P. Putrajaya,2301,3,2304,0,0,70202,35328,105530,0,0,1827,3,474,0,0,0,0,0
7/18/21,Johor,15738,1481,17219,0,0,675877,376936,1052813,22,2,11478,1333,2275,148,1985,0,0,0
7/18/21,Kedah,18789,681,19470,4,0,425292,225631,650923,10,0,14866,675,3923,6,0,0,0,0
7/18/21,Kelantan,14508,1919,16427,1,0,331242,206721,537963,4,0,14307,484,199,1435,0,0,0,2
7/18/21,Melaka,2240,611,2851,0,0,236470,122724,359194,7,0,1230,611,1010,0,0,0,0,0
7/18/21,Negeri Sembilan,17779,1128,18907,2,0,436145,163029,599174,18,2,14514,363,3265,765,0,0,0,0
7/18/21,Pahang,2288,210,2498,1,0,319681,197126,516807,8,1,1093,5,1195,205,0,0,0,0
7/18/21,Perak,12611,429,13040,1,0,574216,297610,871826,12,1,695,400,11916,29,0,0,0,0
7/18/21,Perlis,973,2267,3240,1,0,89547,65465,155012,1,0,973,2267,0,0,0,0,0,0
7/18/21,Pulau Pinang,16852,1050,17902,1,0,506725,214465,721190,15,2,697,132,14144,917,2010,1,0,1
7/18/21,Sabah,9670,4760,14430,3,0,495721,367817,863538,39,9,3291,3701,6379,1059,0,0,0,0
7/18/21,Sarawak,18808,36823,55631,51,1,1633608,947126,2580734,240,39,3962,3372,14827,33451,4,0,0,15
7/18/21,Selangor,72906,21317,94223,5,0,2121279,674983,2796262,87,2,23487,5739,45183,14622,4236,955,0,1
7/18/21,Terengganu,3086,4742,7828,0,0,272017,141746,413763,13,3,2173,2550,913,2183,0,0,0,9
7/18/21,W.P. Kuala Lumpur,41461,24297,65758,10,0,1752012,520667,2272679,115,6,3142,1794,27317,13894,11000,8609,0,2
7/18/21,W.P. Labuan,714,1313,2027,1,0,63204,43069,106273,8,1,702,1309,12,3,0,0,0,1
7/18/21,W.P. Putrajaya,2878,2,2880,0,0,73080,35330,108410,0,0,1799,2,1079,0,0,0,0,0
7/19/21,Johor,22943,3983,26926,0,1,698820,380919,1079739,22,3,14178,2206,5823,1776,2942,1,0,0
7/19/21,Kedah,11060,4456,15516,0,0,436352,230087,666439,10,0,8171,4057,2889,398,0,0,0,1
7/19/21,Kelantan,11970,5558,17528,0,0,343212,212279,555491,4,0,11637,2096,260,3462,0,0,0,73
7/19/21,Melaka,9431,2993,12424,1,1,245901,125717,371618,8,1,7315,1311,2116,1682,0,0,0,0
7/19/21,Negeri Sembilan,12102,4884,16986,1,0,448247,167913,616160,19,2,10405,1292,1697,3590,0,0,0,2
7/19/21,Pahang,8188,6989,15177,0,0,327869,204115,531984,8,1,6547,1958,1641,5031,0,0,0,0
7/19/21,Perak,10890,6004,16894,1,0,585106,303614,888720,13,1,4764,513,6124,5491,0,0,0,2
7/19/21,Perlis,753,643,1396,0,0,90300,66108,156408,1,0,753,602,0,41,0,0,0,0
7/19/21,Pulau Pinang,14396,8075,22471,0,0,521121,222540,743661,15,2,3276,2564,8332,5510,2788,0,0,1
7/19/21,Sabah,16938,3695,20633,2,0,512659,371512,884171,41,9,8600,2487,8337,1208,0,0,0,1
7/19/21,Sarawak,16716,41155,57871,5,0,1650324,988281,2638605,245,39,1283,3332,15403,37774,0,0,0,79
7/19/21,Selangor,89703,32827,122530,2,8,2210982,707810,2918792,89,10,33559,10434,51502,21215,4640,1176,0,4
7/19/21,Terengganu,2696,3185,5881,0,1,274713,144931,419644,13,4,1645,915,1051,2263,0,0,0,7
7/19/21,W.P. Kuala Lumpur,56185,25567,81752,2,1,1808197,546234,2354431,117,7,15916,2394,29200,14202,11061,8968,0,11
7/19/21,W.P. Labuan,581,1844,2425,0,0,63785,44913,108698,8,1,580,1830,1,14,0,0,0,0
7/19/21,W.P. Putrajaya,1472,1451,2923,0,0,74552,36781,111333,0,0,614,925,858,526,0,0,0,0
7/20/21,Johor,25796,2321,28117,1,0,724616,383240,1107856,23,3,17009,7,5782,2314,3005,0,0,0
7/20/21,Kedah,1440,310,1750,0,0,437792,230397,668189,10,0,0,0,1440,310,0,0,0,0
7/20/21,Kelantan,58,6,64,0,0,343270,212285,555555,4,0,58,0,0,6,0,0,0,0
7/20/21,Melaka,2994,104,3098,0,0,248895,125821,374716,8,1,976,2,2018,102,0,0,0,0
7/20/21,Negeri Sembilan,6050,2342,8392,0,0,454297,170255,624552,19,2,4532,1,1518,2341,0,0,0,0
7/20/21,Pahang,1601,324,1925,0,0,329470,204439,533909,8,1,0,0,1601,324,0,0,0,0
7/20/21,Perak,3313,1386,4699,0,0,588419,305000,893419,13,1,3307,4,6,1382,0,0,0,0
7/20/21,Perlis,36,56,92,0,0,90336,66164,156500,1,0,36,1,0,55,0,0,0,0
7/20/21,Pulau Pinang,12408,2230,14638,0,0,533529,224770,758299,15,2,1652,8,8270,2221,2486,1,0,0
7/20/21,Sabah,8025,1943,9968,0,0,520684,373455,894139,41,9,2337,1288,5687,655,0,0,0,1
7/20/21,Sarawak,12941,37990,50931,14,2,1663265,1026271,2689536,259,41,632,4936,12309,33053,0,0,0,1
7/20/21,Selangor,85014,26138,111152,3,2,2295996,733948,3029944,92,12,26042,3664,54470,21309,4498,1164,0,5
7/20/21,Terengganu,763,18,781,0,0,275476,144949,420425,13,4,68,0,695,18,0,0,0,0
7/20/21,W.P. Kuala Lumpur,44278,27250,71528,3,3,1852475,573484,2425959,120,10,13290,1717,22169,16544,8811,8987,0,10
7/20/21,W.P. Labuan,0,59,59,0,0,63785,44972,108757,8,1,0,54,0,5,0,0,0,0
7/20/21,W.P. Putrajaya,2629,12,2641,0,0,77181,36793,113974,0,0,1450,8,1179,4,0,0,0,0
7/21/21,Johor,35213,3643,38856,0,0,759829,386883,1146712,23,3,24608,811,7689,2827,2915,5,0,1
7/21/21,Kedah,5139,763,5902,1,0,442931,231160,674091,11,0,755,3,4384,759,0,0,0,1
7/21/21,Kelantan,1089,582,1671,0,0,344359,212867,557226,4,0,1086,2,3,580,0,0,0,0
7/21/21,Melaka,6899,5126,12025,1,0,255794,130947,386741,9,1,5800,915,1099,4210,0,0,0,1
7/21/21,Negeri Sembilan,11217,7513,18730,1,0,465514,177768,643282,20,2,9516,2256,1700,5256,0,0,0,2
7/21/21,Pahang,11831,6569,18400,2,0,341301,211008,552309,10,1,8706,1138,3122,5431,1,0,0,2
7/21/21,Perak,14762,7098,21860,2,0,603181,312098,915279,15,1,4771,948,9980,6054,2,96,0,9
7/21/21,Perlis,76,77,153,0,0,90412,66241,156653,1,0,76,0,0,77,0,0,0,0
7/21/21,Pulau Pinang,15359,9352,24711,2,0,548888,234122,783010,17,2,2734,3453,9962,5899,2661,0,0,2
7/21/21,Sabah,25185,3290,28475,12,0,545869,376745,922614,53,9,10135,1821,15043,1469,0,0,0,7
7/21/21,Sarawak,17085,43972,61057,51,0,1680350,1070243,2750593,310,41,872,537,16146,43421,0,0,0,81
7/21/21,Selangor,90209,41285,131494,10,2,2386205,775233,3161438,102,14,33896,12291,51674,27835,4634,1158,0,6
7/21/21,Terengganu,3517,4076,7593,0,0,278993,149025,428018,13,4,2543,1191,974,2880,0,0,0,5
7/21/21,W.P. Kuala Lumpur,48105,31888,79993,10,1,1900580,605372,2505952,130,11,16921,3599,21271,19281,9912,9008,0,1
7/21/21,W.P. Labuan,394,2338,2732,1,1,64179,47310,111489,9,2,385,2315,9,20,0,0,0,3
7/21/21,W.P. Putrajaya,1713,1315,3028,0,0,78894,38108,117002,0,0,860,1037,853,278,0,0,0,0
7/22/21,Johor,31830,4669,36499,2,0,791659,391552,1183211,25,3,23979,892,4929,3775,2922,2,0,0
7/22/21,Kedah,12954,3390,16344,0,0,455885,234550,690435,11,0,7343,560,5611,2828,0,0,0,2
7/22/21,Kelantan,12055,3279,15334,0,0,356414,216146,572560,4,0,11983,1404,69,1873,0,0,0,5
7/22/21,Melaka,7314,5894,13208,0,0,263108,136841,399949,9,1,5212,809,2102,5078,0,0,0,7
7/22/21,Negeri Sembilan,14851,9277,24128,0,0,480365,187045,667410,20,2,12858,4954,1992,4320,0,0,0,4
7/22/21,Pahang,14644,4333,18977,0,0,355945,215341,571286,10,1,10699,885,3945,3448,0,0,0,0
7/22/21,Perak,20793,11141,31934,1,0,623974,323239,947213,16,1,18717,1074,2052,10066,0,0,0,25
7/22/21,Perlis,2375,697,3072,0,0,92787,66938,159725,1,0,2369,284,6,413,0,0,0,0
7/22/21,Pulau Pinang,23450,6693,30143,0,0,572338,240815,813153,17,2,7794,1611,12588,5082,3068,0,0,0
7/22/21,Sabah,28930,3655,32585,9,0,574799,380400,955199,62,9,10152,1820,18775,1835,0,0,0,3
7/22/21,Sarawak,10971,45014,55985,19,2,1691321,1115257,2806578,329,43,72,73,10899,44941,0,0,0,0
7/22/21,Selangor,97452,38177,135629,8,0,2483657,813410,3297067,110,14,35907,11420,57141,25488,4404,1267,0,2
7/22/21,Terengganu,4500,4519,9019,0,0,283493,153544,437037,13,4,3594,1535,906,2983,0,0,0,1
7/22/21,W.P. Kuala Lumpur,56804,31919,88723,5,0,1957384,637291,2594675,135,11,17832,2977,28797,19565,10175,9374,0,3
7/22/21,W.P. Labuan,325,1904,2229,0,0,64504,49214,113718,9,2,321,1889,4,15,0,0,0,0
7/22/21,W.P. Putrajaya,2550,1291,3841,0,0,81444,39399,120843,0,0,1095,1080,1455,211,0,0,0,0
7/23/21,Johor,26510,3782,30292,1,0,818169,395334,1213503,26,3,19445,499,4112,3279,2953,4,0,0
7/23/21,Kedah,9626,3246,12872,0,0,465511,237796,703307,11,0,3174,1656,6452,1590,0,0,0,0
7/23/21,Kelantan,802,826,1628,0,0,357216,216972,574188,4,0,802,383,0,443,0,0,0,0
7/23/21,Melaka,6434,6410,12844,1,0,269542,143251,412793,10,1,4372,223,2062,6187,0,0,0,0
7/23/21,Negeri Sembilan,15297,6887,22184,3,1,495662,193932,689594,23,3,13533,2444,1764,4440,0,0,0,3
7/23/21,Pahang,12087,3176,15263,9,0,368032,218517,586549,19,1,9662,1075,2424,2090,0,11,0,1
7/23/21,Perak,17535,14629,32164,4,0,641509,337868,979377,20,1,15937,907,1596,13719,0,0,0,5
7/23/21,Perlis,2399,991,3390,1,0,95186,67929,163115,2,0,2397,844,2,147,0,0,0,0
7/23/21,Pulau Pinang,23511,6614,30125,2,0,595849,247429,843278,19,2,10920,1877,9199,4733,3392,3,0,1
7/23/21,Sabah,33669,2442,36111,10,0,608468,382842,991310,72,9,12989,1366,20380,1076,0,0,0,300
7/23/21,Sarawak,10094,38864,48958,27,1,1701415,1154121,2855536,356,44,1045,1501,9049,37356,0,0,0,7
7/23/21,Selangor,100295,36617,136912,11,0,2583952,850027,3433979,121,14,33532,13040,62449,22367,4303,1209,0,12
7/23/21,Terengganu,1395,1192,2587,1,0,284888,154736,439624,14,4,1307,114,88,1078,0,0,0,0
7/23/21,W.P. Kuala Lumpur,52010,35602,87612,11,0,2009394,672893,2682287,146,11,17985,3258,24383,22932,9050,9409,0,595
7/23/21,W.P. Labuan,260,1329,1589,0,0,64764,50543,115307,9,2,253,1314,7,15,0,0,0,0
7/23/21,W.P. Putrajaya,1617,1359,2976,0,0,83061,40758,123819,0,0,867,1229,750,130,0,0,0,0
7/24/21,Johor,28825,2249,31074,0,0,846994,397583,1244577,26,3,25431,339,1443,1909,1950,1,0,1
7/24/21,Kedah,10053,5342,15395,0,0,475564,243138,718702,11,0,5990,3577,4063,1765,0,0,0,0
7/24/21,Kelantan,339,425,764,0,0,357555,217397,574952,4,0,339,284,0,141,0,0,0,0
7/24/21,Melaka,4987,5413,10400,2,0,274529,148664,423193,12,1,2948,685,2039,4728,0,0,0,0
7/24/21,Negeri Sembilan,15235,3055,18290,0,0,510897,196987,707884,23,3,13269,572,1966,2483,0,0,0,0
7/24/21,Pahang,10429,4510,14939,1,0,378461,223027,601488,20,1,9407,212,1022,4298,0,0,0,0
7/24/21,Perak,15784,13011,28795,5,0,657293,350879,1008172,25,1,13657,569,2127,12426,0,0,0,16
7/24/21,Perlis,1651,474,2125,0,0,96837,68403,165240,2,0,1651,21,0,453,0,0,0,0
7/24/21,Pulau Pinang,19190,5691,24881,1,0,615039,253120,868159,20,2,10099,1158,7220,4532,1870,0,0,2
7/24/21,Sabah,29142,1798,30940,6,0,637610,384640,1022250,78,9,14278,824,14856,972,0,0,0,10
7/24/21,Sarawak,18077,29467,47544,44,1,1719492,1183588,2903080,400,45,12461,7394,5616,22053,0,0,0,20
7/24/21,Selangor,88521,29042,117563,5,1,2672473,879069,3551542,126,15,25161,9175,58674,18913,4681,950,0,9
7/24/21,Terengganu,2146,6659,8805,1,0,287034,161395,448429,15,4,2020,0,126,6659,0,0,0,0
7/24/21,W.P. Kuala Lumpur,45963,28150,74113,2,0,2055357,701043,2756400,148,11,10294,351,26662,19645,9007,8152,0,2
7/24/21,W.P. Labuan,281,1054,1335,0,0,65045,51597,116642,9,2,281,1021,0,33,0,0,0,0
7/24/21,W.P. Putrajaya,2121,909,3030,0,0,85182,41667,126849,0,0,924,695,1197,214,0,0,0,0
7/25/21,Johor,35583,1644,37227,0,0,882577,399227,1281804,26,3,17961,762,15552,871,2070,11,0,0
7/25/21,Kedah,13192,7720,20912,1,0,488756,250858,739614,12,0,8742,4559,4450,3160,0,0,0,1
7/25/21,Kelantan,11747,6752,18499,1,0,369302,224149,593451,5,0,10343,1048,1404,5703,0,0,0,1
7/25/21,Melaka,1969,0,1969,0,0,276498,148664,425162,12,1,1945,0,24,0,0,0,0,0
7/25/21,Negeri Sembilan,9773,3047,12820,0,0,520670,200034,720704,23,3,8534,500,1239,2547,0,0,0,0
7/25/21,Pahang,9380,405,9785,0,0,387841,223432,611273,20,1,8378,7,1002,398,0,0,0,0
7/25/21,Perak,14242,11504,25746,1,0,671535,362383,1033918,26,1,12367,1552,1875,9949,0,0,0,3
7/25/21,Perlis,2003,420,2423,0,0,98840,68823,167663,2,0,2003,10,0,410,0,0,0,0
7/25/21,Pulau Pinang,18549,4809,23358,0,0,633588,257929,891517,20,2,8235,1009,8222,3799,2092,1,0,0
7/25/21,Sabah,26676,786,27462,4,0,664286,385426,1049712,82,9,11890,522,14779,264,0,0,0,7
7/25/21,Sarawak,14473,19014,33487,30,0,1733965,1202602,2936567,430,45,9592,3347,4879,15667,0,0,0,2
7/25/21,Selangor,78415,31253,109668,11,0,2750888,910322,3661210,137,15,18045,9616,55691,20549,4679,1088,0,0
7/25/21,Terengganu,7530,5621,13151,0,0,294564,167016,461580,15,4,7446,1252,83,4357,0,0,0,13
7/25/21,W.P. Kuala Lumpur,43499,29800,73299,1,0,2098856,730843,2829699,149,11,10984,1045,23300,19572,9214,9183,0,1
7/25/21,W.P. Labuan,442,976,1418,1,0,65487,52573,118060,10,2,440,942,2,34,0,0,0,0
7/25/21,W.P. Putrajaya,1721,974,2695,0,0,86903,42641,129544,0,0,865,729,856,245,0,0,0,0
7/26/21,Johor,41799,4399,46198,0,0,924376,403626,1328002,26,3,20904,1040,17911,3348,2984,11,0,0
7/26/21,Kedah,16314,8978,25292,1,0,505070,259836,764906,13,0,9936,1465,6376,7506,0,0,0,9
7/26/21,Kelantan,17555,6069,23624,2,0,386857,230218,617075,7,0,15829,277,1724,5791,0,0,0,3
7/26/21,Melaka,8918,6167,15085,2,0,285416,154831,440247,14,1,8891,774,26,5393,0,0,0,1
7/26/21,Negeri Sembilan,15567,8097,23664,0,0,536237,208131,744368,23,3,14543,986,1022,7111,0,0,0,2
7/26/21,Pahang,18226,6444,24670,1,1,406067,229876,635943,21,2,14354,2548,3872,3896,0,0,0,0
7/26/21,Perak,15419,17118,32537,0,0,686954,379501,1066455,26,1,13678,2555,1736,14559,0,0,0,9
7/26/21,Perlis,2562,671,3233,0,0,101402,69494,170896,2,0,2562,62,0,609,0,0,0,0
7/26/21,Pulau Pinang,19795,7997,27792,1,0,653383,265926,919309,21,2,10781,1228,5952,6765,3061,4,0,1
7/26/21,Sabah,26470,2088,28558,3,0,690756,387514,1078270,85,9,18360,847,8109,1241,1,0,0,0
7/26/21,Sarawak,8653,31312,39965,27,1,1742618,1233914,2976532,457,46,2732,1355,5921,29952,0,0,0,5
7/26/21,Selangor,86658,51526,138184,5,0,2837546,961848,3799394,142,15,31687,14271,52019,33216,2945,4039,0,7
7/26/21,Terengganu,8509,6588,15097,4,0,303073,173604,476677,19,4,7510,1135,999,5437,0,0,0,16
7/26/21,W.P. Kuala Lumpur,51469,34869,86338,10,0,2150325,765712,2916037,159,11,18005,4756,24350,21255,9110,8848,0,14
7/26/21,W.P. Labuan,495,854,1349,0,0,65982,53427,119409,10,2,492,838,3,16,0,0,0,0
7/26/21,W.P. Putrajaya,2358,1749,4107,0,0,89261,44390,133651,0,0,759,1366,1599,383,0,0,0,0
7/27/21,Johor,40850,5475,46325,0,0,965226,409101,1374327,26,3,21192,793,16806,4610,2851,69,0,4
7/27/21,Kedah,17586,8962,26548,2,0,522656,268798,791454,15,0,12502,696,5080,8266,0,0,0,4
7/27/21,Kelantan,17840,7401,25241,6,0,404697,237619,642316,13,0,16436,1548,1404,5853,0,0,0,0
7/27/21,Melaka,9899,7496,17395,15,0,295315,162327,457642,29,1,9877,3095,22,4401,0,0,0,0
7/27/21,Negeri Sembilan,15327,9656,24983,2,0,551564,217787,769351,25,3,13793,1157,1533,8494,0,0,0,6
7/27/21,Pahang,22283,5353,27636,2,0,428350,235229,663579,23,2,17706,1058,4577,4295,0,0,0,0
7/27/21,Perak,16411,14397,30808,3,0,703365,393898,1097263,29,1,14648,2137,1763,12253,0,0,0,7
7/27/21,Perlis,2434,1335,3769,0,0,103836,70829,174665,2,0,2431,73,3,1262,0,0,0,0
7/27/21,Pulau Pinang,23154,7673,30827,6,0,676537,273599,950136,27,2,15611,1106,4474,6561,3069,6,0,0
7/27/21,Sabah,30144,2265,32409,10,0,720900,389779,1110679,95,9,21631,1277,8507,987,5,0,0,2
7/27/21,Sarawak,9928,27635,37563,22,0,1752546,1261549,3014095,479,46,3674,1159,6232,26438,0,33,0,27
7/27/21,Selangor,88993,61717,150710,8,0,2926539,1023565,3950104,150,15,35077,16290,51827,41183,2077,4241,0,15
7/27/21,Terengganu,8710,6849,15559,0,0,311783,180453,492236,19,4,7727,1036,983,5808,0,0,0,5
7/27/21,W.P. Kuala Lumpur,59141,36091,95232,16,1,2209466,801803,3011269,175,12,20190,5138,28620,22349,10298,8603,0,34
7/27/21,W.P. Labuan,399,671,1070,1,0,66381,54098,120479,11,2,393,664,6,7,0,0,0,0
7/27/21,W.P. Putrajaya,2391,1909,4300,0,0,91652,46299,137951,0,0,715,1337,1676,572,0,0,0,0
7/28/21,Johor,36558,5966,42524,8,0,1001784,415067,1416851,34,3,18954,1488,16415,4361,1189,117,0,0
7/28/21,Kedah,16526,10914,27440,9,0,539182,279712,818894,24,0,11508,1150,5017,9674,0,0,0,91
7/28/21,Kelantan,19387,6205,25592,37,0,424084,243824,667908,50,0,18834,1103,553,5100,0,0,0,2
7/28/21,Melaka,10482,4760,15242,14,0,305797,167087,472884,43,1,10477,1405,3,3351,0,0,0,6
7/28/21,Negeri Sembilan,10521,15423,25944,28,0,562085,233210,795295,53,3,8655,8575,1863,6813,1,35,0,2
7/28/21,Pahang,19254,7244,26498,21,0,447604,242473,690077,44,2,14513,1453,4741,5790,0,0,0,1
7/28/21,Perak,11896,19798,31694,11,0,715261,413696,1128957,40,1,8749,2041,3137,17756,0,0,0,11
7/28/21,Perlis,2922,1886,4808,2,0,106758,72715,179473,4,0,2919,754,3,1132,0,0,0,0
7/28/21,Pulau Pinang,23541,5517,29058,8,0,700078,279116,979194,35,2,17167,553,4516,4961,1857,3,0,1
7/28/21,Sabah,32314,1828,34142,105,0,753214,391607,1144821,200,9,21062,649,11251,1179,0,0,0,1
7/28/21,Sarawak,9005,29968,38973,233,2,1761551,1291517,3053068,712,48,2386,563,6614,29394,0,10,0,6
7/28/21,Selangor,109721,54247,163968,171,5,3036260,1077812,4114072,321,20,39597,12327,67389,37565,2723,4348,0,19
7/28/21,Terengganu,8752,7300,16052,6,0,320535,187753,508288,25,4,7736,634,1016,6658,0,0,0,8
7/28/21,W.P. Kuala Lumpur,59427,33213,92640,123,0,2268893,835016,3103909,298,12,21443,4465,31665,19695,6265,9038,0,69
7/28/21,W.P. Labuan,290,678,968,0,0,66671,54776,121447,11,2,287,636,3,41,0,0,0,1
7/28/21,W.P. Putrajaya,2890,1341,4231,1,0,94542,47640,142182,1,0,1030,970,1860,371,0,0,0,0
7/29/21,Johor,40332,8822,49154,14,0,1042116,423889,1466005,48,3,23449,2206,14081,6514,2802,102,0,0
7/29/21,Kedah,15362,10917,26279,8,0,554544,290629,845173,32,0,10134,1455,5227,9461,0,0,0,2
7/29/21,Kelantan,18545,6333,24878,38,0,442629,250157,692786,88,0,18192,243,346,6088,0,0,0,9
7/29/21,Melaka,8181,6272,14453,18,1,313978,173359,487337,61,2,8177,238,4,6031,0,0,0,3
7/29/21,Negeri Sembilan,9975,18955,28930,37,1,572060,252165,824225,90,4,8107,11209,1856,7746,0,0,0,12
7/29/21,Pahang,18470,9563,28033,20,0,466074,252036,718110,64,2,14555,1811,3914,7733,0,19,0,1
7/29/21,Perak,18566,12528,31094,45,1,733827,426224,1160051,85,2,16069,831,2480,11692,0,0,0,22
7/29/21,Perlis,2257,1899,4156,5,0,109015,74614,183629,9,0,2257,72,0,1827,0,0,0,0
7/29/21,Pulau Pinang,21088,6965,28053,13,1,721166,286081,1007247,48,3,15581,784,3467,6178,2039,1,0,3
7/29/21,Sabah,35332,2214,37546,94,0,788546,393821,1182367,294,9,22972,725,12359,1489,0,0,0,1
7/29/21,Sarawak,6784,26389,33173,221,5,1768335,1317906,3086241,933,53,2162,10,4619,26352,0,0,0,30
7/29/21,Selangor,100122,63999,164121,209,1,3136382,1141811,4278193,530,21,40600,15570,56837,44404,2684,4010,0,16
7/29/21,Terengganu,9130,7033,16163,12,0,329665,194786,524451,37,4,8141,272,989,6755,0,0,0,6
7/29/21,W.P. Kuala Lumpur,52981,33879,86860,110,1,2321874,868895,3190769,408,13,20638,4910,26072,20023,6268,8946,0,3
7/29/21,W.P. Labuan,293,364,657,3,0,66964,55140,122104,14,2,293,358,0,6,0,0,0,0
7/29/21,W.P. Putrajaya,2157,1569,3726,1,0,96699,49209,145908,2,0,766,1273,1391,296,0,0,0,0
7/30/21,Johor,38555,7911,46466,15,0,1080671,431800,1512471,63,3,20091,12,16219,7898,2242,1,0,3
7/30/21,Kedah,11633,4813,16446,11,0,566177,295442,861619,43,0,6533,790,2588,4023,2505,0,0,7
7/30/21,Kelantan,2323,23,2346,4,0,444952,250180,695132,92,0,2323,12,0,11,0,0,0,0
7/30/21,Melaka,8684,6165,14849,23,0,322662,179524,502186,84,2,8671,226,5,5938,0,0,0,9
7/30/21,Negeri Sembilan,9900,17168,27068,22,0,581960,269333,851293,112,4,7703,9199,2196,7958,1,11,0,0
7/30/21,Pahang,13716,2071,15787,17,0,479790,254107,733897,81,2,11144,452,2572,1616,0,3,0,0
7/30/21,Perak,14600,17378,31978,12,1,748427,443602,1192029,97,3,10996,1249,3604,16126,0,0,0,3
7/30/21,Perlis,1005,1458,2463,3,0,110020,76072,186092,12,0,1004,135,1,1322,0,0,0,1
7/30/21,Pulau Pinang,18413,7975,26388,16,0,739579,294056,1033635,64,3,12913,1248,3600,6725,1900,2,0,0
7/30/21,Sabah,34577,3751,38328,83,0,823123,397572,1220695,377,9,24001,1023,10527,2728,0,0,0,49
7/30/21,Sarawak,6319,23993,30312,264,7,1774654,1341899,3116553,1197,60,2418,890,3899,23100,0,0,0,5
7/30/21,Selangor,104090,70632,174722,166,5,3240472,1212443,4452915,696,26,37802,20091,63562,46613,2721,3916,0,17
7/30/21,Terengganu,3449,1852,5301,4,0,333114,196638,529752,41,4,2553,22,896,1830,0,0,0,0
7/30/21,W.P. Kuala Lumpur,57869,35014,92883,131,0,2379743,903909,3283652,539,13,18983,5558,33231,20362,5651,9090,0,8
7/30/21,W.P. Labuan,276,463,739,1,1,67240,55603,122843,15,3,273,422,3,38,0,0,0,3
7/30/21,W.P. Putrajaya,4023,1721,5744,8,0,100722,50930,151652,10,0,778,1386,3245,335,0,0,0,0
7/31/21,Johor,33376,17189,50565,19,0,1114047,448989,1563036,82,3,16903,1459,14016,15726,2455,3,0,3
7/31/21,Kedah,15334,4124,19458,12,0,581511,299566,881077,55,0,9864,1854,3831,2266,1639,0,0,4
7/31/21,Kelantan,3220,661,3881,3,0,448172,250841,699013,95,0,3211,2,8,659,0,0,0,1
7/31/21,Melaka,9980,3796,13776,32,0,332642,183320,515962,116,2,9978,1524,1,2272,0,0,0,1
7/31/21,Negeri Sembilan,4416,18884,23300,13,0,586376,288217,874593,125,4,3385,12592,1031,6292,0,0,0,0
7/31/21,Pahang,14021,5734,19755,23,0,493811,259841,753652,104,2,11601,170,2419,5563,0,0,0,2
7/31/21,Perak,11673,17396,29069,40,0,760100,460998,1221098,137,3,8991,261,2681,17130,1,0,0,5
7/31/21,Perlis,1176,762,1938,0,0,111196,76834,188030,12,0,1174,3,1,759,1,0,0,0
7/31/21,Pulau Pinang,17580,3959,21539,13,0,757159,298015,1055174,77,3,12594,88,3128,3865,1854,6,0,4
7/31/21,Sabah,41871,4254,46125,156,0,864994,401826,1266820,533,9,34513,516,7349,3736,0,0,0,11
7/31/21,Sarawak,9141,26715,35856,305,6,1783795,1368614,3152409,1502,66,4314,5301,4826,21413,0,1,0,1
7/31/21,Selangor,103462,59768,163230,133,0,3343934,1272211,4616145,829,26,30074,19595,70695,36236,2625,3934,0,71
7/31/21,Terengganu,9504,12159,21663,23,0,342618,208797,551415,64,4,7352,102,2152,12057,0,0,0,0
7/31/21,W.P. Kuala Lumpur,53630,28433,82063,126,2,2433373,932342,3365715,665,15,15682,3582,32166,15914,5782,8936,0,1
7/31/21,W.P. Labuan,242,444,686,6,0,67482,56047,123529,21,3,242,441,0,3,0,0,0,0
7/31/21,W.P. Putrajaya,3091,2153,5244,2,0,103813,53083,156896,12,0,49,1800,3042,353,0,0,0,0
8/1/21,Johor,34392,10562,44954,13,0,1148439,459551,1607990,95,3,16265,3161,15934,7396,2191,1,0,6
8/1/21,Kedah,16838,6875,23713,5,0,598349,306441,904790,60,0,14006,6077,2605,753,227,45,0,0
8/1/21,Kelantan,19897,5995,25892,46,0,468069,256836,724905,141,0,19877,3681,19,2270,0,0,0,45
8/1/21,Melaka,2591,0,2591,5,0,335233,183320,518553,121,2,2591,0,0,0,0,0,0,0
8/1/21,Negeri Sembilan,5747,17417,23164,6,0,592123,305634,897757,131,4,2194,10930,3551,6487,0,0,0,2
8/1/21,Pahang,7718,5244,12962,10,0,501529,265085,766614,114,2,5334,25,2384,5219,0,0,0,0
8/1/21,Perak,10860,14118,24978,19,0,770960,475116,1246076,156,3,8860,106,1998,14008,0,0,0,6
8/1/21,Perlis,1661,512,2173,0,0,112857,77346,190203,12,0,1637,3,24,509,0,0,0,0
8/1/21,Pulau Pinang,13322,8108,21430,4,0,770481,306123,1076604,81,3,8884,80,2611,8026,1827,2,0,0
8/1/21,Sabah,25632,5909,31541,66,1,890626,407735,1298361,599,10,25474,1088,151,4821,0,0,0,7
8/1/21,Sarawak,7783,22690,30473,160,1,1791578,1391304,3182882,1662,67,4025,4141,3758,18549,0,0,0,0
8/1/21,Selangor,104522,49960,154482,163,0,3448456,1322171,4770627,992,26,31599,12312,70234,33827,2689,3821,0,0
8/1/21,Terengganu,6980,7253,14233,4,0,349598,216050,565648,68,4,6009,904,969,6344,0,0,0,7
8/1/21,W.P. Kuala Lumpur,46028,27450,73478,66,0,2479401,959792,3439193,731,15,8563,3968,31711,14499,5754,8981,0,2
8/1/21,W.P. Labuan,208,487,695,2,0,67690,56534,124224,23,3,207,481,1,5,0,0,0,1
8/1/21,W.P. Putrajaya,2721,2163,4884,1,0,106534,55246,161780,13,0,144,1752,2577,411,0,0,0,0
8/2/21,Johor,37857,12347,50204,13,0,1186296,471898,1658194,108,3,17975,4265,17769,8081,2113,1,0,0
8/2/21,Kedah,15621,13250,28871,21,0,613970,319691,933661,81,0,12832,3561,2627,9687,156,1,0,7
8/2/21,Kelantan,21228,10165,31393,89,0,489297,267001,756298,230,0,21216,4421,12,5353,0,0,0,391
8/2/21,Melaka,9057,5987,15044,32,1,344290,189307,533597,153,3,9049,734,8,5252,0,0,0,1
8/2/21,Negeri Sembilan,7591,15074,22665,10,1,599714,320708,920422,141,5,5087,11212,2502,3846,0,0,0,18
8/2/21,Pahang,17691,5939,23630,21,0,519220,271024,790244,135,2,16321,1538,1370,4401,0,0,0,0
8/2/21,Perak,13812,18188,32000,9,1,784772,493304,1278076,165,4,10957,1310,2853,16859,0,12,0,9
8/2/21,Perlis,1901,971,2872,1,0,114758,78317,193075,13,0,643,35,1258,936,0,0,0,0
8/2/21,Pulau Pinang,18025,7857,25882,13,0,788506,313980,1102486,94,3,13041,706,3217,7149,1766,2,0,1
8/2/21,Sabah,33626,6556,40182,87,2,924252,414291,1338543,686,12,32312,492,1289,6064,0,0,0,25
8/2/21,Sarawak,6022,28742,34764,183,19,1797600,1420046,3217646,1845,86,2545,885,3477,27856,0,0,0,1
8/2/21,Selangor,32704,72272,104976,85,4,3481160,1394443,4875603,1077,30,4186,29334,28515,38837,1,4081,0,22
8/2/21,Terengganu,7179,8039,15218,4,0,356777,224089,580866,72,4,6084,1224,1095,6794,0,0,0,21
8/2/21,W.P. Kuala Lumpur,8250,42621,50871,30,3,2487651,1002413,3490064,761,18,3876,9934,4370,23779,0,8907,0,5
8/2/21,W.P. Labuan,152,507,659,1,0,67842,57041,124883,24,3,152,501,0,6,0,0,0,0
8/2/21,W.P. Putrajaya,2336,1869,4205,5,0,108870,57115,165985,18,0,287,1103,2049,766,0,0,0,0
8/3/21,Johor,38404,13068,51472,26,1,1224700,484966,1709666,134,4,16944,3890,19155,9109,2304,69,0,1
8/3/21,Kedah,14987,16194,31181,17,2,628957,335885,964842,98,2,12581,3479,2284,12708,120,4,0,5
8/3/21,Kelantan,21012,11241,32253,65,2,510309,278242,788551,295,2,20996,991,16,10249,0,0,0,1
8/3/21,Melaka,9692,6349,16041,24,0,353982,195656,549638,177,3,9687,387,5,5961,0,0,0,1
8/3/21,Negeri Sembilan,8997,17066,26063,24,2,608711,337774,946485,165,7,5748,12687,3201,4363,43,5,0,16
8/3/21,Pahang,23408,5656,29064,33,0,542628,276680,819308,168,2,21975,1471,1433,4182,0,0,0,3
8/3/21,Perak,26260,5503,31763,22,1,811032,498807,1309839,187,5,23187,1302,3070,4196,1,0,0,7
8/3/21,Perlis,1396,1831,3227,1,0,116154,80148,196302,14,0,749,206,647,1624,0,0,0,1
8/3/21,Pulau Pinang,18858,10083,28941,5,0,807364,324063,1131427,99,3,15967,830,1281,9209,1609,42,0,3
8/3/21,Sabah,36059,8039,44098,116,3,960311,422330,1382641,802,15,35887,632,128,7406,0,0,0,45
8/3/21,Sarawak,4752,23426,28178,185,13,1802352,1443472,3245824,2030,99,2712,145,1972,23233,0,0,0,116
8/3/21,Selangor,31998,76489,108487,121,1,3513158,1470932,4984090,1198,31,4622,29850,27373,42649,0,3977,0,16
8/3/21,Terengganu,7679,7921,15600,2,0,364456,232010,596466,74,4,6526,560,1152,7351,0,0,0,11
8/3/21,W.P. Kuala Lumpur,5695,44073,49768,14,4,2493346,1046486,3539832,775,22,756,9522,4938,25449,0,9093,0,10
8/3/21,W.P. Labuan,114,388,502,2,1,67956,57429,125385,26,4,112,375,2,13,0,0,0,0
8/3/21,W.P. Putrajaya,1051,2138,3189,0,0,109921,59253,169174,18,0,518,1339,533,799,0,0,0,0
8/4/21,Johor,37557,11874,49431,19,0,1262257,496840,1759097,153,4,28506,4623,6852,7231,2199,20,0,0
8/4/21,Kedah,13195,18495,31690,10,1,642152,354380,996532,108,3,10815,2707,2269,15784,107,0,0,8
8/4/21,Kelantan,20588,13133,33721,46,0,530897,291375,822272,341,2,20562,575,25,12547,0,0,0,12
8/4/21,Melaka,10026,6748,16774,38,1,364008,202404,566412,215,4,10019,410,6,6336,0,0,0,3
8/4/21,Negeri Sembilan,8667,17199,25866,19,0,617378,354973,972351,184,7,5125,13851,3540,3343,0,0,0,7
8/4/21,Pahang,18279,8436,26715,45,1,560907,285116,846023,213,3,16886,3242,1393,5194,0,0,0,0
8/4/21,Perak,25865,5987,31852,13,1,836897,504794,1341691,200,6,24173,1503,1692,4484,0,0,0,0
8/4/21,Perlis,1108,2155,3263,1,0,117262,82303,199565,15,0,782,751,326,1404,0,0,0,0
8/4/21,Pulau Pinang,14858,14178,29036,8,0,822222,338241,1160463,107,3,12109,886,707,13164,2042,125,0,3
8/4/21,Sabah,34110,8446,42556,141,3,994421,430776,1425197,943,18,33924,1275,178,7158,0,11,0,10
8/4/21,Sarawak,3658,21784,25442,150,8,1806010,1465256,3271266,2180,107,1227,46,2430,21736,1,0,0,2
8/4/21,Selangor,31713,86719,118432,60,0,3544871,1557651,5102522,1258,31,4810,34934,26898,47403,4,4377,0,6
8/4/21,Terengganu,6735,8063,14798,12,0,371191,240073,611264,86,4,6137,439,598,7613,0,0,0,11
8/4/21,W.P. Kuala Lumpur,8735,45731,54466,35,1,2502081,1092217,3594298,810,23,2911,11188,5824,25440,0,9103,0,0
8/4/21,W.P. Labuan,215,423,638,1,0,68171,57852,126023,27,4,205,403,10,20,0,0,0,0
8/4/21,W.P. Putrajaya,2405,2284,4689,3,0,112326,61537,173863,21,0,339,1702,2066,581,0,0,0,1
8/5/21,Johor,30721,20208,50929,5,0,1292978,517048,1810026,158,4,17868,13370,10699,6833,2153,4,0,2
8/5/21,Kedah,15407,18771,34178,9,0,657559,373151,1030710,117,3,12992,2990,2242,15781,166,0,0,7
8/5/21,Kelantan,19352,14710,34062,45,0,550249,306085,856334,386,2,19309,362,16,14345,0,0,0,30
8/5/21,Melaka,9836,8792,18628,18,1,373844,211196,585040,233,5,9201,1097,635,7694,0,0,0,1
8/5/21,Negeri Sembilan,8021,17878,25899,18,0,625399,372851,998250,202,7,5011,14481,3010,3392,0,0,0,5
8/5/21,Pahang,18510,11634,30144,33,1,579417,296750,876167,246,4,17041,3241,1469,8392,0,0,0,1
8/5/21,Perak,21096,11268,32364,30,0,857993,516062,1374055,230,6,19482,7260,1614,3896,0,106,0,6
8/5/21,Perlis,617,3180,3797,0,0,117879,85483,203362,15,0,613,3164,4,16,0,0,0,0
8/5/21,Pulau Pinang,14342,15728,30070,12,0,836564,353969,1190533,119,3,11514,1717,855,14001,1964,8,0,11
8/5/21,Sabah,35342,11988,47330,141,0,1029763,442764,1472527,1084,18,35250,2268,83,9717,0,0,0,12
8/5/21,Sarawak,5072,24315,29387,156,6,1811082,1489571,3300653,2336,113,1475,12,3547,24303,0,0,0,50
8/5/21,Selangor,33623,83891,117514,63,2,3578494,1641542,5220036,1321,33,4659,34832,28964,44756,0,4301,0,2
8/5/21,Terengganu,7896,7479,15375,9,1,379087,247552,626639,95,5,7272,271,624,7194,0,0,0,14
8/5/21,W.P. Kuala Lumpur,8138,47691,55829,27,1,2510219,1139908,3650127,837,24,1751,11527,6385,26904,1,9259,0,2
8/5/21,W.P. Labuan,126,452,578,4,0,68297,58304,126601,31,4,120,443,6,9,0,0,0,0
8/5/21,W.P. Putrajaya,2278,2171,4449,1,0,114604,63708,178312,22,0,451,1804,1827,367,0,0,0,0
8/6/21,Johor,37962,9329,47291,18,0,1330940,526377,1857317,176,4,22636,5797,5469,3464,9857,68,0,0
8/6/21,Kedah,14466,11093,25559,20,0,672025,384244,1056269,137,3,10949,2284,2327,8809,1190,0,0,0
8/6/21,Kelantan,2918,1716,4634,10,0,553167,307801,860968,396,2,2918,865,0,851,0,0,0,0
8/6/21,Melaka,9908,7220,17128,17,0,383752,218416,602168,250,5,9312,1241,596,5978,0,0,0,1
8/6/21,Negeri Sembilan,7522,17818,25340,26,0,632921,390669,1023590,228,7,5177,14072,2340,3742,0,0,0,9
8/6/21,Pahang,16202,9395,25597,32,2,595619,306145,901764,278,6,15442,1762,760,7610,0,22,0,1
8/6/21,Perak,14560,19899,34459,32,0,872553,535961,1408514,262,6,4975,10540,8838,8647,743,704,0,12
8/6/21,Perlis,331,1564,1895,0,0,118210,87047,205257,15,0,97,1559,234,4,0,0,0,1
8/6/21,Pulau Pinang,13071,14788,27859,6,0,849635,368757,1218392,125,3,10384,2102,660,12580,2026,102,0,5
8/6/21,Sabah,34261,12010,46271,137,3,1064024,454774,1518798,1221,21,34064,3638,54,8372,110,0,0,33
8/6/21,Sarawak,1928,21298,23226,52,20,1813010,1510869,3323879,2388,133,602,574,1326,20612,0,109,0,3
8/6/21,Selangor,31074,84492,115566,51,3,3609568,1726034,5335602,1372,36,3924,33199,27150,46670,0,4621,0,2
8/6/21,Terengganu,1742,1947,3689,1,0,380829,249499,630328,96,5,491,1125,707,822,544,0,0,0
8/6/21,W.P. Kuala Lumpur,8249,49211,57460,28,5,2518468,1189119,3707587,865,29,3000,12243,5241,27766,4,9192,0,14
8/6/21,W.P. Labuan,190,375,565,2,0,68487,58679,127166,33,4,181,358,9,17,0,0,0,0
8/6/21,W.P. Putrajaya,1881,2057,3938,1,0,116485,65765,182250,23,0,249,1701,1632,354,0,0,0,2
8/7/21,Johor,34320,15694,50014,22,2,1365260,542071,1907331,198,6,19243,12688,7106,3003,7970,3,0,1
8/7/21,Kedah,20772,11430,32202,23,1,692797,395674,1088471,160,4,14799,5853,2434,5575,3539,0,0,2
8/7/21,Kelantan,7879,1058,8937,24,0,561046,308859,869905,420,2,7373,853,506,205,0,0,0,0
8/7/21,Melaka,10415,7105,17520,43,1,394167,225521,619688,293,6,10408,1470,2,5633,0,0,0,7
8/7/21,Negeri Sembilan,6178,16087,22265,13,2,639099,406756,1045855,241,9,4353,12876,1825,3211,0,0,0,0
8/7/21,Pahang,11350,2963,14313,15,0,606969,309108,916077,293,6,10101,895,1245,1927,4,139,0,2
8/7/21,Perak,13133,13909,27042,29,3,885686,549870,1435556,291,9,1984,980,6453,12008,4694,916,0,7
8/7/21,Perlis,1600,41,1641,1,0,119810,87088,206898,16,0,138,27,1462,14,0,0,0,0
8/7/21,Pulau Pinang,11695,11690,23385,9,0,861330,380447,1241777,134,3,9027,129,750,11550,1917,10,0,2
8/7/21,Sabah,29516,13853,43369,132,3,1093540,468627,1562167,1353,24,27036,4309,53,9542,2421,0,0,8
8/7/21,Sarawak,3018,23202,26220,73,20,1816028,1534071,3350099,2461,153,1927,7652,1084,15545,0,0,0,12
8/7/21,Selangor,31415,75518,106933,33,8,3640983,1801552,5442535,1405,44,2647,24951,28766,46464,2,4101,0,2
8/7/21,Terengganu,7078,9962,17040,20,2,387907,259461,647368,116,7,122,8756,5208,1011,1661,195,0,87
8/7/21,W.P. Kuala Lumpur,5207,39437,44644,4,10,2523675,1228556,3752231,869,39,33,5209,5174,25088,0,9139,0,1
8/7/21,W.P. Labuan,87,436,523,0,0,68574,59115,127689,33,4,87,429,0,7,0,0,0,0
8/7/21,W.P. Putrajaya,1810,2151,3961,0,0,118295,67916,186211,23,0,167,1742,1643,409,0,0,0,0
8/8/21,Johor,35426,16069,51495,2,0,1400686,558140,1958826,200,6,13535,12602,16089,3195,5802,270,0,2
8/8/21,Kedah,18381,17100,35481,1,1,711178,412774,1123952,161,5,13420,13647,2158,3403,2797,49,0,7
8/8/21,Kelantan,10483,13685,24168,1,1,571529,322544,894073,421,3,5726,13223,4013,255,741,0,0,210
8/8/21,Melaka,2579,2182,4761,0,0,396746,227703,624449,293,6,2579,1190,0,992,0,0,0,0
8/8/21,Negeri Sembilan,3502,17377,20879,0,1,642601,424133,1066734,241,10,1949,14157,1543,3220,0,0,0,10
8/8/21,Pahang,5972,1360,7332,0,0,612941,310468,923409,293,6,5971,240,0,1120,1,0,0,0
8/8/21,Perak,13779,13167,26946,7,1,899465,563037,1462502,298,10,1952,584,5646,11766,6177,814,0,7
8/8/21,Perlis,853,660,1513,0,0,120663,87748,208411,16,0,495,646,358,14,0,0,0,0
8/8/21,Pulau Pinang,8875,14158,23033,0,1,870205,394605,1264810,134,4,6499,538,348,13614,2025,5,0,4
8/8/21,Sabah,24497,9346,33843,5,2,1118037,477973,1596010,1358,26,20001,2847,19,6492,4472,1,0,11
8/8/21,Sarawak,1764,18744,20508,5,46,1817792,1552815,3370607,2466,199,1108,3550,652,15148,0,44,0,6
8/8/21,Selangor,26325,70399,96724,29,3,3667308,1871951,5539259,1434,47,2604,23131,23715,43254,6,4012,0,2
8/8/21,Terengganu,6399,3851,10250,0,0,394306,263312,657618,116,7,3356,2280,1140,1414,1903,124,0,33
8/8/21,W.P. Kuala Lumpur,4741,37681,42422,1,2,2528416,1266237,3794653,870,41,9,2999,4732,26018,0,8664,0,0
8/8/21,W.P. Labuan,3,13,16,0,0,68577,59128,127705,33,4,3,0,0,13,0,0,0,0
8/8/21,W.P. Putrajaya,1574,2771,4345,0,0,119869,70687,190556,23,0,148,1761,1426,1010,0,0,0,0
8/9/21,Johor,29829,21388,51217,17,0,1430515,579528,2010043,217,6,17556,13421,7198,6859,5074,1108,0,1
8/9/21,Kedah,25045,10845,35890,17,2,736223,423619,1159842,178,7,13715,8010,2223,2752,9104,80,0,6
8/9/21,Kelantan,12040,12419,24459,14,0,583569,334963,918532,435,3,4920,11620,6511,724,600,0,0,84
8/9/21,Melaka,4412,9248,13660,6,1,401158,236951,638109,299,7,2832,7112,1275,2043,305,88,0,5
8/9/21,Negeri Sembilan,7909,12086,19995,12,0,650510,436219,1086729,253,10,3733,10254,3405,1831,718,1,0,53
8/9/21,Pahang,6503,8132,14635,5,1,619444,318600,938044,298,7,4698,6767,596,1364,1209,1,0,0
8/9/21,Perak,20317,11717,32034,25,1,919782,574754,1494536,323,11,4297,4645,7562,6176,8453,892,0,9
8/9/21,Perlis,2267,1549,3816,4,1,122930,89297,212227,20,1,827,1548,0,0,1440,1,0,0
8/9/21,Pulau Pinang,14159,13168,27327,6,0,884364,407773,1292137,140,4,12237,3374,322,8664,1597,1127,0,6
8/9/21,Sabah,27101,14915,42016,69,2,1145138,492888,1638026,1427,28,20113,8092,35,6806,6816,15,0,139
8/9/21,Sarawak,1993,20187,22180,26,9,1819785,1573002,3392787,2492,208,440,1545,1532,17473,2,1149,0,39
8/9/21,Selangor,26681,85964,112645,62,1,3693989,1957915,5651904,1496,48,5683,32737,20997,48598,0,4627,0,3
8/9/21,Terengganu,7322,2912,10234,9,0,401628,266224,667852,125,7,3816,1627,1580,1027,1926,254,0,4
8/9/21,W.P. Kuala Lumpur,9086,54018,63104,19,0,2537502,1320255,3857757,889,41,2794,15450,6292,28237,0,10330,0,1
8/9/21,W.P. Labuan,303,1227,1530,1,1,68880,60355,129235,34,5,292,1216,11,11,0,0,0,0
8/9/21,W.P. Putrajaya,74,1567,1641,0,0,119943,72254,192197,23,0,67,707,7,860,0,0,0,0
8/10/21,Johor,27731,23098,50829,28,0,1458246,602626,2060872,245,6,11151,16668,7509,5470,9069,960,0,2
8/10/21,Kedah,15850,1354,17204,15,0,752073,424973,1177046,193,7,7773,14,2146,1333,5930,7,0,1
8/10/21,Kelantan,2190,94,2284,1,0,585759,335057,920816,436,3,961,80,1229,14,0,0,0,0
8/10/21,Melaka,3139,2859,5998,4,0,404297,239810,644107,303,7,1276,949,1863,1908,0,0,0,2
8/10/21,Negeri Sembilan,4672,5893,10565,9,0,655182,442112,1097294,262,10,2614,4398,1136,1494,922,0,0,1
8/10/21,Pahang,5376,1400,6776,6,0,624820,320000,944820,304,7,4540,17,287,1383,549,0,0,0
8/10/21,Perak,11494,3247,14741,19,0,931276,578001,1509277,342,11,4377,3219,576,27,6540,1,0,1
8/10/21,Perlis,735,34,769,1,0,123665,89331,212996,21,1,120,34,615,0,0,0,0,0
8/10/21,Pulau Pinang,10607,10146,20753,6,0,894971,417919,1312890,146,4,8417,1607,313,7566,1877,973,0,0
8/10/21,Sabah,32264,8448,40712,141,0,1177402,501336,1678738,1568,28,24697,2102,70,6341,7460,3,0,39
8/10/21,Sarawak,1554,13606,15160,43,3,1821339,1586608,3407947,2535,211,731,1018,820,11370,2,1218,0,1
8/10/21,Selangor,28882,82102,110984,184,1,3722871,2040017,5762888,1680,49,2922,25238,25960,52158,0,4684,0,22
8/10/21,Terengganu,14115,1045,15160,25,0,415743,267269,683012,150,7,5058,85,7064,958,1993,0,0,2
8/10/21,W.P. Kuala Lumpur,10055,44393,54448,49,1,2547557,1364648,3912205,938,42,1702,12833,8353,21336,0,10221,0,3
8/10/21,W.P. Labuan,10,4,14,0,0,68890,60359,129249,34,5,0,0,10,4,0,0,0,0
8/10/21,W.P. Putrajaya,390,2463,2853,0,0,120333,74717,195050,23,0,343,1397,47,1066,0,0,0,0
8/11/21,Johor,29190,32454,61644,24,0,1487436,635080,2122516,269,6,7922,24353,16013,7157,5254,944,0,1
8/11/21,Kedah,27686,5729,33415,32,4,779759,430702,1210461,225,11,15453,1484,2415,4189,9809,56,0,9
8/11/21,Kelantan,20008,1504,21512,21,0,605767,336561,942328,457,3,5244,1172,13683,329,1078,0,0,6
8/11/21,Melaka,5649,6829,12478,29,1,409946,246639,656585,332,8,2801,5626,2518,1186,330,11,0,6
8/11/21,Negeri Sembilan,9062,11412,20474,9,0,664244,453524,1117768,271,10,4280,9552,2999,1718,1748,142,0,35
8/11/21,Pahang,8519,11634,20153,7,1,633339,331634,964973,311,8,5053,8477,422,3157,3044,0,0,0
8/11/21,Perak,21537,15429,36966,53,1,952813,593430,1546243,395,12,5180,4975,6594,10010,9424,443,0,340
8/11/21,Perlis,3904,114,4018,3,0,127569,89445,217014,24,1,1417,87,2487,27,0,0,0,0
8/11/21,Pulau Pinang,17254,12946,30200,9,1,912225,430865,1343090,155,5,14221,2718,1138,9076,1894,1151,0,2
8/11/21,Sabah,30622,21339,51961,142,8,1208024,522675,1730699,1710,36,22402,9886,223,11437,7785,11,0,217
8/11/21,Sarawak,3590,16993,20583,47,46,1824929,1603601,3428530,2582,257,519,477,3067,15301,0,1183,0,36
8/11/21,Selangor,28814,85411,114225,123,6,3751685,2125428,5877113,1803,55,6487,33164,22326,48726,1,3510,0,11
8/11/21,Terengganu,17145,4291,21436,88,0,432888,271560,704448,238,7,5074,2484,10117,1330,1947,466,0,18
8/11/21,W.P. Kuala Lumpur,12570,44856,57426,49,5,2560127,1409504,3969631,987,47,3999,16543,8571,20608,0,7690,0,15
8/11/21,W.P. Labuan,328,365,693,3,0,69218,60724,129942,37,5,323,348,5,17,0,0,0,0
8/11/21,W.P. Putrajaya,348,1680,2028,0,0,120681,76397,197078,23,0,348,894,0,786,0,0,0,0
8/12/21,Johor,37034,31285,68319,11,2,1524470,666365,2190835,280,8,8609,23081,22349,5572,6074,2631,0,3
8/12/21,Kedah,20405,13940,34345,14,0,800164,444642,1244806,239,11,9829,8246,2070,5654,8502,39,0,5
8/12/21,Kelantan,13075,11750,24825,8,0,618842,348311,967153,465,3,6007,11538,5683,199,1365,2,0,31
8/12/21,Melaka,6835,6905,13740,15,0,416781,253544,670325,347,8,1129,4795,3779,2043,1927,66,0,1
8/12/21,Negeri Sembilan,7152,14843,21995,5,0,671396,468367,1139763,276,10,4737,12737,1587,1973,646,131,0,184
8/12/21,Pahang,8811,14150,22961,2,0,642150,345784,987934,313,8,5986,10452,1446,3698,1379,0,0,0
8/12/21,Perak,19857,20597,40454,9,1,972670,614027,1586697,404,13,5608,18203,5467,2109,8206,270,0,591
8/12/21,Perlis,1210,2309,3519,0,0,128779,91754,220533,24,1,186,2287,1024,22,0,0,0,0
8/12/21,Pulau Pinang,13849,21894,35743,2,0,926074,452759,1378833,157,5,9709,7560,2112,11483,2027,2851,0,1
8/12/21,Sabah,25046,29265,54311,30,6,1233070,551940,1785010,1740,42,19336,9474,1222,19766,4468,10,0,35
8/12/21,Sarawak,1926,11985,13911,17,14,1826855,1615586,3442441,2599,271,498,50,1424,8509,1,3371,0,58
8/12/21,Selangor,27769,92254,120023,133,6,3779454,2217682,5997136,1936,61,5938,35045,21828,53922,3,3265,0,22
8/12/21,Terengganu,16761,4931,21692,7,0,449649,276491,726140,245,7,5677,3684,9155,1025,1915,216,0,20
8/12/21,W.P. Kuala Lumpur,7934,53052,60986,48,2,2568061,1462556,4030617,1035,49,774,17181,7156,27450,0,8420,0,5
8/12/21,W.P. Labuan,220,286,506,2,1,69438,61010,130448,39,6,219,275,1,11,0,0,0,0
8/12/21,W.P. Putrajaya,372,2385,2757,0,0,121053,78782,199835,23,0,369,1086,3,1299,0,0,0,0
8/13/21,Johor,42445,26021,68466,39,1,1566915,692386,2259301,319,9,7620,19334,31193,4077,3630,2609,0,3
8/13/21,Kedah,12215,9424,21639,11,0,812379,454066,1266445,250,11,5753,2816,1709,6608,4745,0,0,8
8/13/21,Kelantan,1011,795,1806,0,0,619853,349106,968959,465,3,157,793,350,2,504,0,0,0
8/13/21,Melaka,6596,6788,13384,11,1,423377,260332,683709,358,9,500,4564,5214,2137,882,87,0,0
8/13/21,Negeri Sembilan,6430,15408,21838,19,4,677826,483775,1161601,295,14,3725,13406,2557,1910,148,90,0,2
8/13/21,Pahang,8225,11804,20029,6,2,650375,357588,1007963,319,10,2687,9361,1701,2442,3837,1,0,0
8/13/21,Perak,14807,17454,32261,25,4,987477,631481,1618958,429,17,4239,15737,6335,1642,3668,69,0,571
8/13/21,Perlis,807,2271,3078,5,0,129586,94025,223611,29,1,92,2258,715,13,0,0,0,0
8/13/21,Pulau Pinang,13440,21923,35363,4,2,939514,474682,1414196,161,7,8802,10472,2686,8502,1951,2949,0,1
8/13/21,Sabah,20113,32832,52945,87,9,1253183,584772,1837955,1827,51,12419,12656,2334,20153,5340,19,0,24
8/13/21,Sarawak,2116,12966,15082,28,12,1828971,1628552,3457523,2627,283,943,830,1136,8446,2,3543,0,182
8/13/21,Selangor,30237,97566,127803,124,9,3809691,2315248,6124939,2060,70,5590,32806,24644,60165,2,4592,0,4
8/13/21,Terengganu,3731,921,4652,2,2,453380,277412,730792,247,9,486,793,3245,127,0,0,0,1
8/13/21,W.P. Kuala Lumpur,9003,51080,60083,39,5,2577064,1513636,4090700,1074,54,1060,17337,7943,23612,0,10091,0,40
8/13/21,W.P. Labuan,147,335,482,0,0,69585,61345,130930,39,6,145,329,2,6,0,0,0,0
8/13/21,W.P. Putrajaya,404,1592,1996,1,0,121457,80374,201831,24,0,397,881,7,711,0,0,0,0
8/14/21,Johor,36081,27615,63696,56,0,1602996,720001,2322997,375,9,6668,24615,22855,1171,6556,1827,0,4
8/14/21,Kedah,14382,9697,24079,13,0,826761,463763,1290524,263,11,5688,5536,2938,4153,5753,5,0,6
8/14/21,Kelantan,700,279,979,0,0,620553,349385,969938,465,3,208,276,1,3,491,0,0,0
8/14/21,Melaka,7210,4878,12088,31,2,430587,265210,695797,389,11,36,2857,5363,2020,1803,1,0,8
8/14/21,Negeri Sembilan,3685,15688,19373,7,4,681511,499463,1180974,302,18,1444,13760,2241,1928,0,0,0,0
8/14/21,Pahang,3163,10869,14032,9,1,653538,368457,1021995,328,11,899,9817,1384,1052,880,0,0,0
8/14/21,Perak,13947,14902,28849,55,2,1001424,646383,1647807,484,19,1647,12861,8628,2036,3630,1,0,46
8/14/21,Perlis,1638,1599,3237,0,0,131224,95624,226848,29,1,34,1591,1604,7,0,0,0,1
8/14/21,Pulau Pinang,12555,18310,30865,2,0,952069,492992,1445061,163,7,5786,9957,4660,6294,2106,2059,0,3
8/14/21,Sabah,21933,28235,50168,99,5,1275116,613007,1888123,1926,56,12049,13239,5455,14981,4404,4,0,36
8/14/21,Sarawak,2597,21519,24116,90,34,1831568,1650071,3481639,2717,317,1412,12317,1180,6500,2,2580,0,125
8/14/21,Selangor,23215,84374,107589,75,4,3832906,2399622,6232528,2135,74,2532,24047,20683,56345,0,3976,0,6
8/14/21,Terengganu,15487,2094,17581,75,0,468867,279506,748373,322,9,60,1967,15388,125,12,0,0,29
8/14/21,W.P. Kuala Lumpur,9402,45029,54431,46,0,2586466,1558665,4145131,1120,54,1656,9910,7746,25233,0,9884,0,2
8/14/21,W.P. Labuan,134,155,289,1,0,69719,61500,131219,40,6,132,150,2,5,0,0,0,0
8/14/21,W.P. Putrajaya,144,1956,2100,0,0,121601,82330,203931,24,0,6,910,138,1046,0,0,0,0
8/15/21,Johor,27094,34843,61937,25,0,1630090,754844,2384934,400,9,2086,17457,20985,15503,4023,1882,0,1
8/15/21,Kedah,11700,12544,24244,10,1,838461,476307,1314768,273,12,3258,8386,2652,4156,5775,1,0,16
8/15/21,Kelantan,9603,11375,20978,17,1,630156,360760,990916,482,4,4756,10024,3718,1347,1110,1,0,22
8/15/21,Melaka,2214,1876,4090,9,0,432801,267086,699887,398,11,370,1851,1844,25,0,0,0,0
8/15/21,Negeri Sembilan,3776,10055,13831,9,0,685287,509518,1194805,311,18,799,8824,2974,1231,0,0,0,3
8/15/21,Pahang,2130,9220,11350,0,0,655668,377677,1033345,328,11,1775,8134,355,1081,0,0,0,5
8/15/21,Perak,8178,13706,21884,22,0,1009602,660089,1669691,506,19,1287,11747,5626,1863,1265,95,0,1
8/15/21,Perlis,1270,1907,3177,0,0,132494,97531,230025,29,1,16,1906,1254,1,0,0,0,0
8/15/21,Pulau Pinang,11384,14446,25830,3,0,963453,507438,1470891,166,7,4566,5467,4818,7002,2000,1977,0,0
8/15/21,Sabah,19950,24478,44428,76,1,1295066,637485,1932551,2002,57,10747,10929,5210,13542,3953,4,0,43
8/15/21,Sarawak,1123,16853,17976,38,11,1832691,1666924,3499615,2755,328,687,8937,423,5155,12,2758,0,4
8/15/21,Selangor,22734,75912,98646,64,8,3855640,2475534,6331174,2199,82,3228,17692,19504,53696,2,4523,0,1
8/15/21,Terengganu,16054,7397,23451,40,0,484921,286903,771824,362,9,834,7169,15210,220,0,0,0,18
8/15/21,W.P. Kuala Lumpur,9302,42543,51845,30,0,2595768,1601208,4196976,1150,54,692,10606,8610,21937,0,9999,0,1
8/15/21,W.P. Labuan,8,3,11,0,0,69727,61503,131230,40,6,0,0,8,2,0,0,0,1
8/15/21,W.P. Putrajaya,2,1590,1592,0,0,121603,83920,205523,24,0,0,876,2,714,0,0,0,0
8/16/21,Johor,30150,40468,70618,26,0,1660240,795312,2455552,426,9,2036,20396,23988,17289,4125,2781,0,3
8/16/21,Kedah,11307,15300,26607,20,1,849768,491607,1341375,293,13,3328,9532,2750,5764,5220,3,0,10
8/16/21,Kelantan,10375,16812,27187,13,0,640531,377572,1018103,495,4,2319,15135,6530,1664,1524,0,0,15
8/16/21,Melaka,11539,7810,19349,43,0,444340,274896,719236,441,11,164,7704,11371,105,0,0,0,5
8/16/21,Negeri Sembilan,6587,15831,22418,17,0,691874,525349,1217223,328,18,2540,14498,4042,1237,5,93,0,3
8/16/21,Pahang,6390,17561,23951,9,1,662058,395238,1057296,337,12,71,13789,6318,3771,0,0,0,2
8/16/21,Perak,11999,15891,27890,18,0,1021601,675980,1697581,524,19,712,13546,10811,1914,473,424,0,10
8/16/21,Perlis,789,2512,3301,0,0,133283,100043,233326,29,1,459,2508,330,4,0,0,0,0
8/16/21,Pulau Pinang,15220,14723,29943,12,0,978673,522161,1500834,178,7,4503,5824,9139,5817,1578,3082,0,0
8/16/21,Sabah,30326,25324,55650,122,1,1325392,662809,1988201,2124,58,12249,17298,11004,8009,7031,11,0,48
8/16/21,Sarawak,2445,12092,14537,57,9,1835136,1679016,3514152,2812,337,999,2520,1425,6019,3,3510,0,61
8/16/21,Selangor,14317,86342,100659,65,4,3869957,2561876,6431833,2264,86,6334,30711,7976,50529,6,5094,0,9
8/16/21,Terengganu,17612,8244,25856,39,0,502533,295147,797680,401,9,1430,7303,16153,903,0,23,0,44
8/16/21,W.P. Kuala Lumpur,9831,50759,60590,33,8,2605599,1651967,4257566,1183,62,1178,17590,8652,23067,0,10100,0,3
8/16/21,W.P. Labuan,112,727,839,4,0,69839,62230,132069,44,6,112,724,0,3,0,0,0,0
8/16/21,W.P. Putrajaya,624,2328,2952,0,0,122227,86248,208475,24,0,618,763,6,1565,0,0,0,0
8/17/21,Johor,33192,39510,72702,31,0,1693432,834822,2528254,457,9,1926,20562,28416,16130,2850,2815,0,3
8/17/21,Kedah,11204,16669,27873,20,1,860972,508276,1369248,313,14,3420,11835,3174,4807,4605,23,0,9
8/17/21,Kelantan,10580,16886,27466,15,5,651111,394458,1045569,510,9,3436,15461,5596,1424,1514,0,0,35
8/17/21,Melaka,13210,6111,19321,36,0,457550,281007,738557,477,11,114,6023,13073,86,22,0,0,3
8/17/21,Negeri Sembilan,6113,14914,21027,10,2,697987,540263,1238250,338,20,2437,13649,3674,1210,2,54,0,1
8/17/21,Pahang,7181,21495,28676,9,1,669239,416733,1085972,346,13,40,16908,7141,4587,0,0,0,0
8/17/21,Perak,13301,16116,29417,21,1,1034902,692096,1726998,545,20,531,14169,11057,1938,1713,0,0,9
8/17/21,Perlis,1091,2355,3446,1,0,134374,102398,236772,30,1,628,2334,463,18,0,0,0,3
8/17/21,Pulau Pinang,14981,16373,31354,12,0,993654,538534,1532188,190,7,4383,9199,8879,4120,1719,3002,0,52
8/17/21,Sabah,31485,28518,60003,135,4,1356877,691327,2048204,2259,62,10182,20841,14259,7665,6955,8,0,93
8/17/21,Sarawak,2242,12386,14628,53,8,1837378,1691402,3528780,2865,345,968,3679,1245,5469,1,3206,0,60
8/17/21,Selangor,13496,88839,102335,63,5,3883453,2650715,6534168,2327,91,5168,34639,8309,49264,2,4931,0,22
8/17/21,Terengganu,20013,8705,28718,58,0,522546,303852,826398,459,9,1680,7586,18331,1106,0,0,0,15
8/17/21,W.P. Kuala Lumpur,10244,55798,66042,24,7,2615843,1707765,4323608,1207,69,452,18998,9790,26969,0,9782,0,51
8/17/21,W.P. Labuan,118,498,616,0,0,69957,62728,132685,44,6,118,492,0,6,0,0,0,0
8/17/21,W.P. Putrajaya,305,2304,2609,1,0,122532,88552,211084,25,0,296,724,9,1580,0,0,0,0
8/18/21,Johor,33148,37133,70281,60,10,1726580,871955,2598535,517,19,1476,18579,28084,16021,3587,2532,0,2
8/18/21,Kedah,14250,15627,29877,31,8,875222,523903,1399125,344,22,2261,10602,7802,5019,4180,1,0,12
8/18/21,Kelantan,10847,18328,29175,23,25,661958,412786,1074744,533,34,3310,17284,6031,783,1501,24,0,242
8/18/21,Melaka,13725,5618,19343,73,4,471275,286625,757900,550,15,89,4875,13636,300,0,440,0,3
8/18/21,Negeri Sembilan,7822,10359,18181,7,28,705809,550622,1256431,345,48,3316,8544,4506,1774,0,34,0,7
8/18/21,Pahang,6662,18238,24900,12,18,675901,434971,1110872,358,31,67,13264,6595,4973,0,0,0,1
8/18/21,Perak,16377,11809,28186,49,11,1051279,703905,1755184,594,31,249,8669,13991,3124,2129,1,0,23
8/18/21,Perlis,719,2956,3675,4,3,135093,105354,240447,34,4,268,2945,451,11,0,0,0,0
8/18/21,Pulau Pinang,14633,16828,31461,12,6,1008287,555362,1563649,202,13,3776,10543,8935,3960,1922,2323,0,2
8/18/21,Sabah,28684,30783,59467,146,102,1385561,722110,2107671,2405,164,8242,20136,14669,10615,5657,16,0,132
8/18/21,Sarawak,1893,10742,12635,72,235,1839271,1702144,3541415,2937,580,506,2282,1385,5444,0,2991,0,27
8/18/21,Selangor,15783,109475,125258,148,166,3899236,2760190,6659426,2475,257,6410,38983,9373,65447,0,5040,0,5
8/18/21,Terengganu,19388,8833,28221,80,5,541934,312685,854619,539,14,1676,7450,17690,1305,3,66,0,31
8/18/21,W.P. Kuala Lumpur,10105,60805,70910,31,127,2625948,1768570,4394518,1238,196,510,20780,9594,29710,0,10287,0,29
8/18/21,W.P. Labuan,98,314,412,1,1,70055,63042,133097,45,7,93,305,5,9,0,0,0,0
8/18/21,W.P. Putrajaya,355,2754,3109,1,1,122887,91306,214193,26,1,345,1029,10,1725,0,0,0,0
8/19/21,Johor,33014,39281,72295,73,14,1759594,911236,2670830,590,33,6851,23004,21955,13689,4207,2586,0,3
8/19/21,Kedah,12171,14912,27083,22,8,887393,538815,1426208,366,30,1859,9367,5125,5532,5148,3,0,49
8/19/21,Kelantan,10627,18104,28731,25,37,672585,430890,1103475,558,71,3065,17460,5591,640,1970,0,0,5
8/19/21,Melaka,11714,6018,17732,64,4,482989,292643,775632,614,19,83,3924,11631,56,0,2038,0,0
8/19/21,Negeri Sembilan,7057,10067,17124,6,37,712866,560689,1273555,351,85,3485,8189,3572,1874,0,0,0,4
8/19/21,Pahang,10184,14543,24727,19,20,686085,449514,1135599,377,51,276,9720,9908,4823,0,0,0,0
8/19/21,Perak,9603,18065,27668,25,46,1060882,721970,1782852,619,77,433,15798,9169,2250,0,0,0,18
8/19/21,Perlis,1235,2194,3429,2,5,136328,107548,243876,36,9,209,2186,1026,8,0,0,0,0
8/19/21,Pulau Pinang,15041,15634,30675,16,11,1023328,570996,1594324,218,24,3726,9147,9256,3868,2059,2617,0,2
8/19/21,Sabah,25271,31727,56998,152,86,1410832,753837,2164669,2557,250,7436,20732,12820,10977,5002,8,0,23
8/19/21,Sarawak,1682,10412,12094,67,249,1840953,1712556,3553509,3004,829,341,2115,1333,5029,3,3266,0,7
8/19/21,Selangor,13438,98632,112070,80,208,3912674,2858822,6771496,2555,465,6092,39170,7337,54574,2,4877,0,18
8/19/21,Terengganu,17151,9225,26376,39,23,559085,321910,880995,578,37,1618,7815,15501,1387,0,0,0,55
8/19/21,W.P. Kuala Lumpur,14516,56850,71366,60,122,2640464,1825420,4465884,1298,318,1164,20271,13352,26901,0,9650,0,28
8/19/21,W.P. Labuan,69,312,381,1,2,70124,63354,133478,46,9,67,306,2,6,0,0,0,0
8/19/21,W.P. Putrajaya,416,2131,2547,6,1,123303,93437,216740,32,2,401,764,15,1367,0,0,0,0
8/20/21,Johor,29394,38708,68102,53,15,1788988,949944,2738932,643,48,15313,19927,12458,16239,1622,2540,0,3
8/20/21,Kedah,14430,9066,23496,41,11,901823,547881,1449704,407,41,12363,6394,399,2667,1663,1,0,9
8/20/21,Kelantan,921,2234,3155,0,4,673506,433124,1106630,558,75,139,2214,193,20,589,0,0,0
8/20/21,Melaka,11988,7469,19457,76,22,494977,300112,795089,690,41,931,5504,11056,60,0,1903,0,3
8/20/21,Negeri Sembilan,7782,10375,18157,19,26,720648,571064,1291712,370,111,3898,7839,3883,2515,0,20,0,2
8/20/21,Pahang,5762,18000,23762,19,30,691847,467514,1159361,396,81,531,15516,5231,2462,0,22,0,0
8/20/21,Perak,13740,15019,28759,30,29,1074622,736989,1811611,649,106,7421,11407,6317,3606,0,0,0,8
8/20/21,Perlis,1136,1022,2158,1,3,137464,108570,246034,37,12,100,1018,1036,4,0,0,0,0
8/20/21,Pulau Pinang,15830,18049,33879,25,16,1039158,589045,1628203,243,40,4954,11979,8773,3381,2103,2689,0,0
8/20/21,Sabah,21779,31685,53464,209,81,1432611,785522,2218133,2766,331,7616,22390,10854,9209,3284,5,0,106
8/20/21,Sarawak,2686,11153,13839,136,301,1843639,1723709,3567348,3140,1130,1369,2343,1316,5418,0,3390,0,3
8/20/21,Selangor,15060,104659,119719,111,168,3927734,2963481,6891215,2666,633,7443,37493,7616,62285,0,4843,0,39
8/20/21,Terengganu,1756,4056,5812,9,7,560841,325966,886807,587,44,629,2281,1127,917,0,0,0,858
8/20/21,W.P. Kuala Lumpur,13909,60671,74580,69,137,2654373,1886091,4540464,1367,455,1577,18667,12332,32362,0,9615,0,27
8/20/21,W.P. Labuan,72,261,333,2,2,70196,63615,133811,48,11,38,257,6,4,0,0,0,28
8/20/21,W.P. Putrajaya,354,3795,4149,2,8,123657,97232,220889,34,10,348,784,6,3011,0,0,0,0
8/21/21,Johor,33245,31516,64761,43,21,1822233,981460,2803693,686,69,22769,16014,9577,13585,898,1914,0,4
8/21/21,Kedah,15760,12994,28754,29,8,917583,560875,1478458,436,49,13754,9215,1054,3775,951,2,0,3
8/21/21,Kelantan,895,3640,4535,2,5,674401,436764,1111165,560,80,4,3625,241,12,598,0,0,55
8/21/21,Melaka,11245,4792,16037,56,23,506222,304904,811126,746,64,62,4626,11183,165,0,0,0,1
8/21/21,Negeri Sembilan,4005,4982,8987,7,12,724653,576046,1300699,377,123,1645,3838,2360,1142,0,0,0,2
8/21/21,Pahang,9111,13753,22864,17,22,700958,481267,1182225,413,103,869,11356,8242,2397,0,0,0,0
8/21/21,Perak,13064,11003,24067,56,24,1087686,747992,1835678,705,130,11851,8589,1212,2391,0,22,0,2
8/21/21,Perlis,1282,1172,2454,2,0,138746,109742,248488,39,12,297,1168,985,3,0,0,0,1
8/21/21,Pulau Pinang,12284,17226,29510,33,14,1051442,606271,1657713,276,54,3229,11866,5333,3381,3721,1971,0,9
8/21/21,Sabah,18700,34575,53275,194,136,1451311,820097,2271408,2960,467,9846,30389,5460,4085,3387,35,0,73
8/21/21,Sarawak,1922,11604,13526,80,290,1845561,1735313,3580874,3220,1420,1342,4779,578,4438,1,2364,0,24
8/21/21,Selangor,14903,103742,118645,165,140,3942637,3067223,7009860,2831,773,4852,28905,10049,70305,0,4290,0,244
8/21/21,Terengganu,7421,8849,16270,73,20,568262,334815,903077,660,64,4866,6369,2555,2163,0,0,0,317
8/21/21,W.P. Kuala Lumpur,17578,56227,73805,65,123,2671951,1942318,4614269,1432,578,709,15170,16869,31640,0,9370,0,47
8/21/21,W.P. Labuan,39,205,244,0,3,70235,63820,134055,48,14,20,204,0,1,0,0,0,19
8/21/21,W.P. Putrajaya,0,2965,2965,0,2,123657,100197,223854,34,12,0,60,0,2905,0,0,0,0
8/22/21,Johor,31435,34035,65470,83,14,1853668,1015495,2869163,769,83,18294,16568,10607,15618,2534,1844,0,5
8/22/21,Kedah,13605,15652,29257,35,5,931188,576527,1507715,471,54,13349,13218,193,2422,48,1,0,26
8/22/21,Kelantan,3843,19594,23437,11,45,678244,456358,1134602,571,125,2302,19286,911,63,600,0,0,275
8/22/21,Melaka,1722,2553,4275,3,5,507944,307457,815401,749,69,178,2528,1543,24,0,0,0,2
8/22/21,Negeri Sembilan,4232,5505,9737,2,6,728885,581551,1310436,379,129,981,2154,3251,3351,0,0,0,0
8/22/21,Pahang,4257,7394,11651,10,8,705215,488661,1193876,423,111,910,5145,3347,2050,0,199,0,0
8/22/21,Perak,9559,11067,20626,30,21,1097245,759059,1856304,735,151,8783,8741,524,2322,0,0,0,256
8/22/21,Perlis,811,1592,2403,0,0,139557,111334,250891,39,12,177,1588,634,3,0,0,0,1
8/22/21,Pulau Pinang,9827,15852,25679,14,4,1061269,622123,1683392,290,58,2622,10857,4370,3413,2834,1581,0,2
8/22/21,Sabah,17314,24693,42007,174,66,1468625,844790,2313415,3134,533,9450,23736,5330,949,2526,5,0,11
8/22/21,Sarawak,1108,10096,11204,50,146,1846669,1745409,3592078,3270,1566,637,3533,469,4182,0,2373,0,10
8/22/21,Selangor,15344,103505,118849,177,167,3957981,3170728,7128709,3008,940,4660,31100,10684,68306,0,4085,0,14
8/22/21,Terengganu,12687,6548,19235,81,3,580949,341363,922312,741,67,12594,5907,66,638,0,0,0,30
8/22/21,W.P. Kuala Lumpur,13799,49170,62969,82,71,2685750,1991488,4677238,1514,649,300,8603,13497,31429,0,9077,0,63
8/22/21,W.P. Labuan,8,2,10,0,0,70243,63822,134065,48,14,0,0,8,2,0,0,0,0
8/22/21,W.P. Putrajaya,1,2579,2580,0,1,123658,102776,226434,34,13,0,174,1,2405,0,0,0,0
8/23/21,Johor,33004,38068,71072,53,14,1886672,1053563,2940235,822,97,22941,17816,8497,17313,1565,2936,0,4
8/23/21,Kedah,18716,14825,33541,47,17,949904,591352,1541256,518,71,15943,12353,90,2440,2678,21,0,16
8/23/21,Kelantan,6464,20226,26690,13,88,684708,476584,1161292,584,213,3228,20116,2605,108,600,0,0,33
8/23/21,Melaka,4216,9724,13940,15,32,512160,317181,829341,764,101,250,9311,3966,28,0,385,0,0
8/23/21,Negeri Sembilan,6878,7931,14809,18,10,735763,589482,1325245,397,139,6012,5389,861,2534,0,0,0,13
8/23/21,Pahang,3265,15847,19112,3,22,708480,504508,1212988,426,133,786,15333,2479,513,0,0,0,1
8/23/21,Perak,12560,13929,26489,38,8,1109805,772988,1882793,773,159,12336,10989,224,2899,0,41,0,0
8/23/21,Perlis,3136,1843,4979,27,1,142693,113177,255870,66,13,2209,612,710,1220,217,11,0,0
8/23/21,Pulau Pinang,12168,22731,34899,13,13,1073437,644854,1718291,303,71,4261,17062,4282,2902,3622,2765,0,5
8/23/21,Sabah,17232,29622,46854,169,100,1485857,874412,2360269,3303,633,10890,27291,3709,2144,2608,161,0,51
8/23/21,Sarawak,1856,9367,11223,41,181,1848525,1754776,3603301,3311,1747,498,2780,1348,3093,3,3487,0,14
8/23/21,Selangor,10837,35417,46254,48,49,3968818,3206145,7174963,3056,989,6274,4601,4540,26252,22,4555,0,10
8/23/21,Terengganu,13218,7943,21161,124,5,594167,349306,943473,865,72,12981,6091,234,1851,0,0,0,4
8/23/21,W.P. Kuala Lumpur,7601,20850,28451,23,35,2693351,2012338,4705689,1537,684,1678,4391,5921,4912,0,11370,0,179
8/23/21,W.P. Labuan,97,365,462,1,5,70340,64187,134527,49,19,65,359,0,6,0,0,0,32
8/23/21,W.P. Putrajaya,870,2277,3147,0,5,124528,105053,229581,34,18,852,340,18,1937,0,0,0,0
8/24/21,Johor,32556,38679,71235,80,30,1919228,1092242,3011470,902,127,22215,16974,8491,18605,1848,3095,0,7
8/24/21,Kedah,19011,16076,35087,78,22,968915,607428,1576343,596,93,16737,13419,323,2635,1941,2,0,30
8/24/21,Kelantan,9486,20356,29842,38,64,694194,496940,1191134,622,277,5793,20203,3093,150,600,0,0,3
8/24/21,Melaka,3324,11493,14817,12,31,515484,328674,844158,776,132,571,11418,2753,32,0,43,0,0
8/24/21,Negeri Sembilan,7145,8983,16128,21,25,742908,598465,1341373,418,164,6326,5834,723,3148,94,0,0,3
8/24/21,Pahang,4365,23517,27882,32,32,712845,528025,1240870,458,165,893,21891,3472,1626,0,0,0,0
8/24/21,Perak,12691,25375,38066,66,23,1122496,798363,1920859,839,182,11358,22798,232,2575,1099,0,0,4
8/24/21,Perlis,3354,1374,4728,9,1,146047,114551,260598,75,14,2620,742,360,630,374,1,0,1
8/24/21,Pulau Pinang,10351,25524,35875,16,15,1083788,670378,1754166,319,86,1653,21265,4762,1369,3935,2888,0,3
8/24/21,Sabah,18325,31801,50126,125,109,1504182,906213,2410395,3428,742,11538,30996,4472,580,2305,156,0,79
8/24/21,Sarawak,1923,5913,7836,88,191,1850448,1760689,3611137,3399,1938,689,2736,1211,2236,0,911,0,53
8/24/21,Selangor,10257,35637,45894,59,46,3979075,3241782,7220857,3115,1035,6297,5542,3960,25482,0,4595,0,18
8/24/21,Terengganu,15051,6945,21996,274,1,609218,356251,965469,1139,73,14962,6449,79,496,0,0,0,10
8/24/21,W.P. Kuala Lumpur,8878,19014,27892,15,22,2702229,2031352,4733581,1552,706,1781,1165,7095,6479,0,11369,0,3
8/24/21,W.P. Labuan,56,202,258,0,2,70396,64389,134785,49,21,50,199,6,3,0,0,0,0
8/24/21,W.P. Putrajaya,437,1053,1490,0,0,124965,106106,231071,34,18,426,529,11,524,0,0,0,0
8/25/21,Johor,31217,38143,69360,133,18,1950445,1130385,3080830,1035,145,19064,28245,10194,6808,1957,3088,0,4
8/25/21,Kedah,21261,14373,35634,56,10,990176,621801,1611977,652,103,18725,11105,425,3141,2094,104,0,40
8/25/21,Kelantan,12889,19597,32486,29,58,707083,516537,1223620,651,335,10192,19487,2095,87,600,23,0,2
8/25/21,Melaka,3310,14834,18144,20,50,518794,343508,862302,796,182,416,14803,2894,29,0,0,0,2
8/25/21,Negeri Sembilan,8181,8676,16857,30,19,751089,607141,1358230,448,183,7318,5203,778,3471,85,0,0,2
8/25/21,Pahang,4947,18140,23087,13,46,717792,546165,1263957,471,211,2798,16595,2149,1545,0,0,0,0
8/25/21,Perak,14648,25415,40063,84,14,1137144,823778,1960922,923,196,11607,23752,670,1661,2366,0,0,7
8/25/21,Perlis,4219,1124,5343,12,1,150266,115675,265941,87,15,1704,797,2515,327,0,0,0,0
8/25/21,Pulau Pinang,9876,21120,30996,10,12,1093664,691498,1785162,329,98,4253,17616,4244,650,1378,2852,0,3
8/25/21,Sabah,17268,35290,52558,121,154,1521450,941503,2462953,3549,896,11129,33293,4558,1976,1574,5,0,23
8/25/21,Sarawak,1698,4421,6119,50,158,1852146,1765110,3617256,3449,2096,655,1154,1008,2395,0,858,0,49
8/25/21,Selangor,11924,36401,48325,76,55,3990999,3278183,7269182,3191,1090,6241,5493,5682,26107,0,4743,0,59
8/25/21,Terengganu,14792,7138,21930,295,13,624010,363389,987399,1434,86,14123,6047,655,1036,0,43,0,26
8/25/21,W.P. Kuala Lumpur,7143,20734,27877,17,39,2709372,2052086,4761458,1569,745,1890,3303,5243,6217,10,11212,0,2
8/25/21,W.P. Labuan,42,214,256,0,1,70438,64603,135041,49,22,17,198,0,16,0,0,0,25
8/25/21,W.P. Putrajaya,444,2350,2794,1,3,125409,108456,233865,35,21,436,356,8,1994,0,0,0,0
8/26/21,Johor,33361,30964,64325,153,4,1983806,1161349,3145155,1188,149,17472,17634,10360,10212,5515,3117,0,15
8/26/21,Kedah,19225,16207,35432,93,8,1009401,638008,1647409,745,111,17988,13728,5,2464,1077,6,0,164
8/26/21,Kelantan,12981,19508,32489,42,46,720064,536045,1256109,693,381,10656,19413,1724,85,600,9,0,2
8/26/21,Melaka,3861,14309,18170,53,36,522655,357817,880472,849,218,353,13591,3508,653,0,65,0,0
8/26/21,Negeri Sembilan,7522,8061,15583,47,18,758611,615202,1373813,495,201,6987,5031,534,3028,0,0,0,3
8/26/21,Pahang,3251,16024,19275,16,31,721043,562189,1283232,487,242,2088,14416,1163,1606,0,0,0,2
8/26/21,Perak,17705,20875,38580,110,28,1154849,844653,1999502,1033,224,14923,19136,460,1693,2311,44,0,13
8/26/21,Perlis,2016,608,2624,0,0,152282,116283,268565,87,15,2010,602,5,6,0,0,0,1
8/26/21,Pulau Pinang,9307,20982,30289,8,17,1102971,712480,1815451,337,115,4226,16704,4125,1436,955,2839,0,4
8/26/21,Sabah,17778,35264,53042,155,127,1540540,976767,2515995,3704,1023,11303,32706,5020,1221,1265,3,1312,212
8/26/21,Sarawak,1488,7897,9385,40,148,1853634,1773007,3626641,3489,2244,249,1407,1193,5565,0,914,0,57
8/26/21,Selangor,11096,38883,49979,77,57,4002095,3317066,7319161,3268,1147,5403,4725,5693,29670,0,4396,0,92
8/26/21,Terengganu,13941,6803,20744,234,7,637951,370192,1008143,1668,93,13920,6526,16,246,0,0,0,36
8/26/21,W.P. Kuala Lumpur,5232,20597,25829,11,29,2714604,2072683,4787287,1580,774,1835,2115,3397,7054,0,11423,0,5
8/26/21,W.P. Labuan,52,119,171,1,5,70490,64722,135212,50,27,50,115,2,4,0,0,0,0
8/26/21,W.P. Putrajaya,382,2351,2733,0,1,125791,110807,236598,35,22,375,495,7,1855,0,0,0,1
8/27/21,Johor,27838,30723,58561,86,19,2011644,1192072,3203716,1274,168,17537,22278,5288,5425,5013,3019,0,1
8/27/21,Kedah,20567,12453,33020,241,21,1029968,650461,1680429,986,132,17115,10061,2209,2384,1243,0,0,8
8/27/21,Kelantan,5878,2794,8672,8,9,725942,538839,1264781,701,390,5468,2786,410,8,0,0,0,0
8/27/21,Melaka,2985,13226,16211,40,23,525640,371043,896683,889,241,599,12561,2386,652,0,11,0,2
8/27/21,Negeri Sembilan,6520,7590,14110,45,28,765131,622792,1387923,540,229,6057,5312,427,2273,36,0,0,5
8/27/21,Pahang,4925,17890,22815,18,34,725968,580079,1306047,505,276,3755,16764,1170,1123,0,0,0,3
8/27/21,Perak,24125,14130,38255,115,40,1178974,858783,2037757,1148,264,22500,5322,395,8709,934,0,0,395
8/27/21,Perlis,1752,325,2077,2,0,154034,116608,270642,89,15,1747,98,5,227,0,0,0,0
8/27/21,Pulau Pinang,9817,14567,24384,26,6,1112788,727047,1839835,363,121,3702,10461,4863,1279,1250,2823,0,6
8/27/21,Sabah,17537,31462,48999,157,154,1559028,1008229,2564994,3861,1177,11550,30059,5012,376,973,3,951,75
8/27/21,Sarawak,1981,3557,5538,61,99,1855615,1776564,3632179,3550,2343,518,592,1444,2063,0,884,0,37
8/27/21,Selangor,10518,35615,46133,181,58,4012613,3352681,7365294,3449,1205,7061,5467,3451,25754,2,4251,0,147
8/27/21,Terengganu,1477,1655,3132,8,2,639428,371847,1011275,1676,95,510,470,0,1180,967,4,0,1
8/27/21,W.P. Kuala Lumpur,6910,19421,26331,39,35,2721514,2092104,4813618,1619,809,2278,3402,4632,5498,0,10506,0,15
8/27/21,W.P. Labuan,63,159,222,2,0,70553,64881,135434,52,27,62,149,1,10,0,0,0,0
8/27/21,W.P. Putrajaya,411,1929,2340,1,1,126202,112736,238938,36,23,405,308,6,1621,0,0,0,0
8/28/21,Johor,33507,27171,60678,176,20,2045151,1219243,3264394,1450,188,27478,18771,5242,6518,787,1881,0,1
8/28/21,Kedah,14301,17776,32077,291,23,1044269,668237,1712506,1277,155,11359,15008,2941,2756,1,0,0,12
8/28/21,Kelantan,9672,7858,17530,13,26,735614,546697,1282311,714,416,9631,7374,41,484,0,0,0,0
8/28/21,Melaka,5412,13293,18705,118,48,531052,384336,915388,1007,289,1072,13072,4340,221,0,0,0,0
8/28/21,Negeri Sembilan,6719,5832,12551,14,12,771850,628624,1400474,554,241,5822,4078,380,1702,517,0,0,52
8/28/21,Pahang,5798,10864,16662,16,15,731766,590943,1322709,521,291,4962,9616,382,1248,431,0,0,23
8/28/21,Perak,17768,8911,26679,263,30,1196742,867694,2064436,1411,294,13390,2277,921,6625,3457,4,0,5
8/28/21,Perlis,1119,1551,2670,0,1,155153,118159,273312,89,16,1119,138,0,1413,0,0,0,0
8/28/21,Pulau Pinang,9608,12422,22030,27,9,1122396,739469,1861865,390,130,1909,8833,3867,1392,3831,2189,0,9
8/28/21,Sabah,15726,30336,46062,180,122,1581415,1038565,2611056,4041,1299,11336,21931,3366,1563,866,152,6661,187
8/28/21,Sarawak,1254,3319,4573,33,80,1856869,1779883,3636752,3583,2423,605,2171,649,1145,0,0,0,3
8/28/21,Selangor,7160,36934,44094,80,66,4019773,3389615,7409388,3529,1271,3829,2955,3331,29503,0,4248,0,228
8/28/21,Terengganu,10806,4820,15626,241,20,650234,376667,1026901,1917,115,8370,128,6,4449,2429,242,0,2
8/28/21,W.P. Kuala Lumpur,9069,16205,25274,5,7,2730583,2108309,4838892,1624,816,1612,198,7457,6297,0,9705,0,5
8/28/21,W.P. Labuan,61,125,186,0,3,70614,65006,135620,52,30,35,123,26,2,0,0,0,0
8/28/21,W.P. Putrajaya,0,1956,1956,0,0,126202,114692,240894,36,23,0,174,0,1782,0,0,0,0
8/29/21,Johor,27654,31075,58729,134,2,2072805,1250318,3323123,1584,190,22457,13533,4286,15694,911,1846,0,2
8/29/21,Kedah,16071,15359,31430,207,0,1060340,683596,1743936,1484,155,15324,13128,14,2166,666,5,0,127
8/29/21,Kelantan,18483,10522,29005,54,1,754097,557219,1311316,768,417,17081,6642,57,3876,1344,0,0,5
8/29/21,Melaka,2821,2485,5306,73,0,533873,386821,920694,1080,289,1084,2485,1737,0,0,0,0,0
8/29/21,Negeri Sembilan,5650,3297,8947,111,0,777500,631921,1409421,665,241,5006,1661,643,1636,0,0,0,1
8/29/21,Pahang,5545,6512,12057,19,0,737311,597455,1334766,540,291,2959,6509,447,3,2090,0,0,49
8/29/21,Perak,20928,7022,27950,193,1,1217700,874716,2092386,1604,295,17322,1891,765,5090,2841,11,30,0
8/29/21,Perlis,1532,824,2356,1,0,156685,118983,275668,90,16,1531,478,1,346,0,0,0,0
8/29/21,Pulau Pinang,11169,8588,19757,17,0,1133565,748057,1881622,407,130,2254,6290,6038,450,2876,1847,0,2
8/29/21,Sabah,13625,25290,38915,118,10,1601977,1063855,2649971,4159,1309,10375,18061,2737,284,509,3,6937,9
8/29/21,Sarawak,521,1946,2467,27,6,1857390,1781829,3639219,3610,2429,386,1293,134,648,0,0,0,6
8/29/21,Selangor,6529,33532,40061,51,19,4026302,3423147,7449449,3580,1290,3165,2625,3358,26972,0,3711,0,230
8/29/21,Terengganu,8396,5107,13503,123,0,658630,381774,1040404,2040,115,6860,3385,174,1671,1297,18,0,98
8/29/21,W.P. Kuala Lumpur,6201,15213,21414,5,3,2736784,2123522,4860306,1629,819,1024,306,5177,6086,0,8766,0,55
8/29/21,W.P. Labuan,12,0,12,0,0,70626,65006,135632,52,30,0,0,12,0,0,0,0,0
8/29/21,W.P. Putrajaya,0,1582,1582,0,0,126202,116274,242476,36,23,0,168,0,1414,0,0,0,0
8/30/21,Johor,31390,26647,58037,163,10,2104195,1276965,3381160,1747,200,25792,16988,3170,6897,2426,2758,0,6
8/30/21,Kedah,21721,15839,37560,246,8,1082061,699435,1781496,1730,163,20519,13584,16,2251,1149,2,0,39
8/30/21,Kelantan,22448,11354,33802,76,13,776545,568573,1345118,844,430,20443,5213,161,6135,1657,0,0,193
8/30/21,Melaka,6863,5775,12638,302,6,540736,392596,933332,1382,295,6313,4737,9,884,541,154,0,0
8/30/21,Negeri Sembilan,5759,7267,13026,179,9,783259,639188,1422447,844,250,4817,3931,458,3336,483,0,0,1
8/30/21,Pahang,15179,6002,21181,46,5,752490,603457,1355947,586,296,14512,5371,7,631,660,0,0,0
8/30/21,Perak,22784,11506,34290,166,5,1240492,886222,2126676,1770,300,21470,4350,278,7148,1021,0,8,15
8/30/21,Perlis,1555,810,2365,0,4,158240,119793,278033,90,20,1553,796,2,14,0,0,0,0
8/30/21,Pulau Pinang,9675,15092,24767,28,5,1143240,763149,1906389,435,135,6253,11823,1970,445,1446,2818,0,12
8/30/21,Sabah,19746,21576,41322,138,40,1624287,1085431,2691293,4297,1349,14704,18262,2724,674,1090,3,2564,1301
8/30/21,Sarawak,1202,2262,3464,47,20,1858592,1784091,3642683,3657,2449,392,411,795,1745,0,98,0,23
8/30/21,Selangor,7061,31048,38109,83,40,4033363,3454195,7487558,3663,1330,4320,6350,2735,20670,0,3717,0,317
8/30/21,Terengganu,8674,5498,14172,120,8,667304,387272,1054576,2160,123,8161,3877,38,1590,473,18,0,15
8/30/21,W.P. Kuala Lumpur,11022,23458,34480,16,35,2747806,2146980,4894786,1645,854,1600,2833,9420,9297,0,11305,0,25
8/30/21,W.P. Labuan,104,249,353,0,1,70730,65255,135985,52,31,102,230,2,11,0,0,0,8
8/30/21,W.P. Putrajaya,522,150,672,2,0,126724,116424,243148,38,23,517,129,5,21,0,0,0,0
8/31/21,Johor,34350,20716,55066,352,10,2138545,1297681,3436226,2099,210,29288,10665,984,7272,4075,2778,0,4
8/31/21,Kedah,13943,9358,23301,123,7,1096004,708793,1804797,1853,170,13127,7367,3,1962,766,0,0,76
8/31/21,Kelantan,14729,1295,16024,25,1,791274,569868,1361142,869,431,13506,818,316,477,0,0,0,907
8/31/21,Melaka,6461,3419,9880,288,4,547197,396015,943212,1670,299,6448,1293,13,2126,0,0,0,0
8/31/21,Negeri Sembilan,92,3411,3503,0,7,783351,642599,1425950,844,257,92,2302,0,1109,0,0,0,0
8/31/21,Pahang,5109,4004,9113,6,6,757599,607461,1365060,592,302,4322,3731,1,273,786,0,0,0
8/31/21,Perak,6111,4705,10816,83,13,1246603,890927,2137492,1853,313,5968,4185,143,520,0,0,0,0
8/31/21,Perlis,63,672,735,0,1,158303,120465,278768,90,21,63,105,0,567,0,0,0,0
8/31/21,Pulau Pinang,8861,11142,20003,31,5,1152101,774291,1926392,466,140,6275,8065,881,344,1705,2732,0,1
8/31/21,Sabah,18735,23905,42640,255,96,1644957,1109336,2733933,4552,1445,13678,21648,4633,280,97,0,1935,369
8/31/21,Sarawak,290,938,1228,9,31,1858882,1785029,3643911,3666,2480,126,583,164,355,0,0,0,0
8/31/21,Selangor,3534,33071,36605,58,142,4036897,3487266,7524163,3721,1472,1663,2173,1867,26782,0,3943,0,177
8/31/21,Terengganu,6571,11788,18359,137,22,673875,399060,1072935,2297,145,5361,4783,0,7005,1210,0,0,0
8/31/21,W.P. Kuala Lumpur,2450,20584,23034,3,22,2750256,2167564,4917820,1648,876,535,1530,1914,7717,1,11336,0,1
8/31/21,W.P. Labuan,0,15,15,0,0,70730,65270,136000,52,31,0,2,0,13,0,0,0,0
8/31/21,W.P. Putrajaya,2,330,332,0,0,126726,116754,243480,38,23,1,328,1,2,0,0,0,0
9/1/21,Johor,34872,26131,61003,382,29,2173417,1323812,3497229,2481,239,30418,8315,2017,15106,2413,2708,0,26
9/1/21,Kedah,16285,18006,34291,190,21,1112289,726799,1839088,2043,191,14044,15154,853,2773,1281,0,0,186
9/1/21,Kelantan,18434,19275,37709,110,19,809708,589143,1398851,979,450,15716,5757,1191,13466,1404,36,0,139
9/1/21,Melaka,12387,5294,17681,280,16,559584,401309,960893,1950,315,11092,3003,86,2290,1209,0,0,1
9/1/21,Negeri Sembilan,4722,8909,13631,96,9,788073,651508,1439581,940,266,3945,5585,775,3321,0,0,0,5
9/1/21,Pahang,20808,7168,27976,125,6,778407,614629,1393036,717,308,18980,6695,1149,438,658,32,0,24
9/1/21,Perak,29627,11271,40898,381,8,1276369,902198,2178390,2234,321,26813,5308,296,5821,2506,0,139,15
9/1/21,Perlis,860,3699,4559,6,3,159163,124164,283327,96,24,857,1324,3,2374,0,0,0,1
9/1/21,Pulau Pinang,8732,18319,27051,47,9,1160833,792610,1953443,513,149,6042,14209,1223,1337,1459,2732,0,49
9/1/21,Sabah,20459,24486,44945,243,108,1666942,1133822,2778878,4795,1553,14780,22358,5122,536,0,0,1526,623
9/1/21,Sarawak,1022,2154,3176,36,32,1859904,1787183,3647087,3702,2512,387,517,617,1348,0,87,0,220
9/1/21,Selangor,6883,34676,41559,77,90,4043780,3521942,7565722,3798,1562,4484,7010,2294,22930,0,4311,0,530
9/1/21,Terengganu,7693,14404,22097,144,77,681568,413464,1095032,2441,222,6397,5131,3,9048,1266,225,0,27
9/1/21,W.P. Kuala Lumpur,8757,22959,31716,8,29,2759013,2190523,4949536,1656,905,1004,4012,7753,7637,0,11310,0,0
9/1/21,W.P. Labuan,60,299,359,0,2,70790,65569,136359,52,33,56,288,4,10,0,0,0,1
9/1/21,W.P. Putrajaya,123,366,489,1,0,126849,117120,243969,39,23,123,363,0,3,0,0,0,0